Year,Winner,ScoreW,Loser,ScoreL,Combined
1939,OREGON,56,TEXAS,41,97
1939,OKLAHOMA,50,UTAHSTATE,39,89
1939,VILLANOVA,42,BROWN,30,72
1939,OHIOSTATE,64,WAKEFOREST,52,116
1939,OREGON,55,OKLAHOMA,37,92
1939,OHIOSTATE,53,VILLANOVA,36,89
1939,OREGON,46,OHIOSTATE,33,79
1940,INDIANA,48,SPRINGFIELD,24,72
1940,DUQUESNE,30,WESTERNKENTUCKY,29,59
1940,SOUTHERNCALIFORNIA,38,COLORADO,32,70
1940,KANSAS,50,RICE,44,94
1940,INDIANA,39,DUQUESNE,30,69
1940,KANSAS,43,SOUTHERNCALIFORNIA,42,85
1940,INDIANA,60,KANSAS,42,102
1941,WISCONSIN,51,DARTMOUTH,50,101
1941,PITTSBURGH,26,NORTHCAROLINA,20,46
1941,ARKANSAS,52,WYOMING,40,92
1941,WASHINGTONSTATE,48,CREIGHTON,39,87
1941,WISCONSIN,36,PITTSBURGH,30,66
1941,WASHINGTONSTATE,64,ARKANSAS,53,117
1941,WISCONSIN,39,WASHINGTONSTATE,34,73
1942,DARTMOUTH,44,PENNSTATE,39,83
1942,KENTUCKY,46,ILLINOIS,44,90
1942,STANFORD,53,RICE,47,100
1942,COLORADO,46,KANSAS,44,90
1942,DARTMOUTH,48,KENTUCKY,28,76
1942,STANFORD,46,COLORADO,35,81
1942,STANFORD,53,DARTMOUTH,38,91
1943,GEORGETOWN,55,NYU,36,91
1943,DEPAUL,46,DARTMOUTH,35,81
1943,TEXAS,59,WASHINGTON,55,114
1943,WYOMING,53,OKLAHOMA,50,103
1943,GEORGETOWN,53,DEPAUL,49,102
1943,WYOMING,58,TEXAS,54,112
1943,WYOMING,46,GEORGETOWN,34,80
1944,DARTMOUTH,63,CATHOLIC,38,101
1944,OHIOSTATE,57,TEMPLE,47,104
1944,IOWASTATE,44,PEPPERDINE,39,83
1944,UTAH,45,MISSOURI,35,80
1944,DARTMOUTH,60,OHIOSTATE,53,113
1944,UTAH,40,IOWASTATE,31,71
1944,UTAH,42,DARTMOUTH,40,82
1945,NYU,59,TUFTS,44,103
1945,OHIOSTATE,45,KENTUCKY,37,82
1945,ARKANSAS,79,OREGON,76,155
1945,OKLAHOMASTATE,62,UTAH,37,99
1945,NYU,70,OHIOSTATE,65,135
1945,OKLAHOMASTATE,68,ARKANSAS,41,109
1945,OKLAHOMASTATE,49,NYU,45,94
1946,OHIOSTATE,46,HARVARD,38,84
1946,NORTHCAROLINA,57,NYU,49,106
1946,OKLAHOMASTATE,44,BAYLOR,29,73
1946,CALIFORNIA,50,COLORADO,44,94
1946,NORTHCAROLINA,60,OHIOSTATE,57,117
1946,OKLAHOMASTATE,52,CALIFORNIA,35,87
1946,OKLAHOMASTATE,43,NORTHCAROLINA,40,83
1947,HOLYCROSS,55,NAVY,47,102
1947,CCNY,70,WISCONSIN,56,126
1947,TEXAS,42,WYOMING,40,82
1947,OKLAHOMA,56,OREGONSTATE,54,110
1947,HOLYCROSS,60,CCNY,45,105
1947,OKLAHOMA,55,TEXAS,54,109
1947,HOLYCROSS,58,OKLAHOMA,47,105
1948,KENTUCKY,76,COLUMBIA,53,129
1948,HOLYCROSS,63,MICHIGAN,45,108
1948,KANSASSTATE,58,WYOMING,48,106
1948,BAYLOR,64,WASHINGTON,62,126
1948,KENTUCKY,60,HOLYCROSS,52,112
1948,BAYLOR,60,KANSASSTATE,52,112
1948,KENTUCKY,58,BAYLOR,42,100
1949,ILLINOIS,71,YALE,67,138
1949,KENTUCKY,85,VILLANOVA,72,157
1949,OKLAHOMASTATE,40,WYOMING,39,79
1949,OREGONSTATE,56,ARKANSAS,38,94
1949,KENTUCKY,76,ILLINOIS,47,123
1949,OKLAHOMASTATE,55,OREGONSTATE,30,85
1949,KENTUCKY,46,OKLAHOMASTATE,36,82
1950,CCNY,56,OHIOSTATE,55,111
1950,N.CAROLINASTATE,87,HOLYCROSS,74,161
1950,BAYLOR,56,BRIGHAMYOUNG,55,111
1950,BRADLEY,73,UCLA,59,132
1950,CCNY,78,N.CAROLINASTATE,73,151
1950,BRADLEY,68,BAYLOR,66,134
1950,CCNY,71,BRADLEY,68,139
1951,KANSASSTATE,61,ARIZONA,59,120
1951,BRIGHAMYOUNG,68,SANJOSESTATE,61,129
1951,OKLAHOMASTATE,50,MONTANASTATE,46,96
1951,WASHINGTON,62,TEXASA&M,40,102
1951,ILLINOIS,79,COLUMBIA,71,150
1951,N.CAROLINASTATE,67,VILLANOVA,62,129
1951,KENTUCKY,79,LOUISVILLE,68,147
1951,ST.JOHN'S,63,CONNECTICUT,52,115
1951,KANSASSTATE,64,BRIGHAMYOUNG,54,118
1951,OKLAHOMASTATE,61,WASHINGTON,57,118
1951,ILLINOIS,84,N.CAROLINASTATE,70,154
1951,KENTUCKY,59,ST.JOHN'S,43,102
1951,KANSASSTATE,68,OKLAHOMASTATE,44,112
1951,KENTUCKY,76,ILLINOIS,74,150
1951,KENTUCKY,68,KANSASSTATE,58,126
1952,KENTUCKY,82,PENNSTATE,54,136
1952,ST.JOHN'S,60,N.CAROLINASTATE,49,109
1952,ILLINOIS,80,DAYTON,61,141
1952,DUQUESNE,60,PRINCETON,49,109
1952,KANSAS,68,TCU,64,132
1952,ST.LOUIS,62,NEWMEXICOSTATE,53,115
1952,SANTACLARA,68,UCLA,59,127
1952,WYOMING,54,OKLAHOMACITY,48,102
1952,ST.JOHN'S,64,KENTUCKY,57,121
1952,ILLINOIS,74,DUQUESNE,68,142
1952,KANSAS,74,ST.LOUIS,55,129
1952,SANTACLARA,56,WYOMING,53,109
1952,ST.JOHN'S,61,ILLINOIS,59,120
1952,KANSAS,74,SANTACLARA,55,129
1952,KANSAS,80,ST.JOHN'S,63,143
1953,LEBANONVALLEY,80,FORDHAM,67,147
1953,HOLYCROSS,87,NAVY,74,161
1953,NOTREDAME,72,EASTERNKENTUCKY,57,129
1953,DEPAUL,74,MIAMI(OHIO),72,146
1953,SEATTLE,88,IDAHOSTATE,77,165
1953,SANTACLARA,81,HARDIN-SIMMONS,56,137
1953,LSU,89,LEBANONVALLEY,76,165
1953,HOLYCROSS,79,WAKEFOREST,71,150
1953,NOTREDAME,69,PENNSYLVANIA,57,126
1953,INDIANA,82,DEPAUL,80,162
1953,WASHINGTON,92,SEATTLE,70,162
1953,SANTACLARA,67,WYOMING,52,119
1953,OKLAHOMASTATE,71,TCU,54,125
1953,KANSAS,73,OKLAHOMACITY,65,138
1953,LSU,81,HOLYCROSS,73,154
1953,INDIANA,79,NOTREDAME,66,145
1953,WASHINGTON,74,SANTACLARA,62,136
1953,KANSAS,61,OKLAHOMASTATE,55,116
1953,INDIANA,80,LSU,67,147
1953,KANSAS,79,WASHINGTON,53,132
1953,INDIANA,69,KANSAS,68,137
1954,PENNSTATE,62,TOLEDO,50,112
1954,NOTREDAME,80,LOYOLA(N.O.),70,150
1954,NAVY,85,CONNECTICUT,80,165
1954,N.CAROLINASTATE,75,GEORGEWASHINGTON,73,148
1954,LASALLE,76,FORDHAM,74,150
1954,BRADLEY,61,OKLAHOMACITY,55,116
1954,IDAHOSTATE,77,SEATTLE,75,152
1954,SANTACLARA,73,TEXASTECH,64,137
1954,PENNSTATE,78,LSU,70,148
1954,NOTREDAME,65,INDIANA,64,129
1954,NAVY,69,CORNELL,67,136
1954,LASALLE,88,N.CAROLINASTATE,81,169
1954,BRADLEY,76,COLORADO,64,140
1954,OKLAHOMASTATE,51,RICE,45,96
1954,SOUTHERNCALIFORNIA,73,IDAHOSTATE,59,132
1954,SANTACLARA,73,COLORADOSTATE,50,123
1954,PENNSTATE,71,NOTREDAME,63,134
1954,LASALLE,64,NAVY,48,112
1954,BRADLEY,71,OKLAHOMASTATE,57,128
1954,SOUTHERNCALIFORNIA,66,SANTACLARA,65,131
1954,LASALLE,69,PENNSTATE,54,123
1954,BRADLEY,74,SOUTHERNCALIFORNIA,72,146
1954,LASALLE,92,BRADLEY,76,168
1955,MARQUETTE,90,MIAMI(OHIO),79,169
1955,PENNSTATE,59,MEMPHISSTATE,55,114
1955,LASALLE,95,WESTVIRGINIA,61,156
1955,CANISIUS,73,WILLIAMS,60,133
1955,VILLANOVA,74,DUKE,73,147
1955,BRADLEY,69,OKLAHOMACITY,65,134
1955,SEATTLE,80,IDAHOSTATE,63,143
1955,SANFRANCISCO,89,WESTTEXASSTATE,66,155
1955,MARQUETTE,79,KENTUCKY,71,150
1955,IOWA,82,PENNSTATE,53,135
1955,LASALLE,73,PRINCETON,46,119
1955,CANISIUS,73,VILLANOVA,71,144
1955,BRADLEY,81,SMU,79,160
1955,COLORADO,69,TULSA,59,128
1955,OREGONSTATE,83,SEATTLE,71,154
1955,SANFRANCISCO,78,UTAH,59,137
1955,IOWA,86,MARQUETTE,81,167
1955,LASALLE,99,CANISIUS,64,163
1955,COLORADO,93,BRADLEY,81,174
1955,SANFRANCISCO,57,OREGONSTATE,56,113
1955,LASALLE,76,IOWA,73,149
1955,SANFRANCISCO,62,COLORADO,50,112
1955,SANFRANCISCO,77,LASALLE,63,140
1956,CONNECTICUT,84,MANHATTAN,75,159
1956,TEMPLE,74,HOLYCROSS,72,146
1956,DARTMOUTH,61,WESTVIRGINIA,59,120
1956,CANISIUS,79,N.CAROLINASTATE,78,157
1956,MOREHEADSTATE,107,MARSHALL,92,199
1956,WAYNESTATE,72,DEPAUL,63,135
1956,SMU,68,TEXASTECH,67,135
1956,OKLAHOMACITY,97,MEMPHISSTATE,81,178
1956,SEATTLE,68,IDAHOSTATE,66,134
1956,TEMPLE,65,CONNECTICUT,59,124
1956,CANISIUS,66,DARTMOUTH,58,124
1956,IOWA,97,MOREHEADSTATE,83,180
1956,KENTUCKY,84,WAYNESTATE,64,148
1956,SMU,89,HOUSTON,74,163
1956,OKLAHOMACITY,97,KANSASSTATE,93,190
1956,UTAH,81,SEATTLE,72,153
1956,SANFRANCISCO,72,UCLA,61,133
1956,TEMPLE,60,CANISIUS,58,118
1956,IOWA,89,KENTUCKY,77,166
1956,SMU,84,OKLAHOMACITY,63,147
1956,SANFRANCISCO,92,UTAH,77,169
1956,IOWA,83,TEMPLE,76,159
1956,SANFRANCISCO,86,SMU,68,154
1956,SANFRANCISCO,83,IOWA,71,154
1957,SYRACUSE,82,CONNECTICUT,76,158
1957,CANISIUS,64,WESTVIRGINIA,56,120
1957,NORTHCAROLINA,90,YALE,74,164
1957,PITTSBURGH,86,MOREHEADSTATE,85,171
1957,NOTREDAME,89,MIAMI(OHIO),77,166
1957,OKLAHOMACITY,76,LOYOLA(N.O.),55,131
1957,IDAHOSTATE,68,HARDIN-SIMMONS,57,125
1957,SYRACUSE,75,LAFAYETTE,71,146
1957,NORTHCAROLINA,87,CANISIUS,75,162
1957,KENTUCKY,98,PITTSBURGH,92,190
1957,MICHIGANSTATE,85,NOTREDAME,83,168
1957,OKLAHOMACITY,75,ST.LOUIS,66,141
1957,KANSAS,73,SMU,65,138
1957,CALIFORNIA,86,BRIGHAMYOUNG,59,145
1957,SANFRANCISCO,66,IDAHOSTATE,51,117
1957,NORTHCAROLINA,67,SYRACUSE,58,125
1957,MICHIGANSTATE,80,KENTUCKY,68,148
1957,KANSAS,81,OKLAHOMACITY,61,142
1957,SANFRANCISCO,50,CALIFORNIA,46,96
1957,NORTHCAROLINA,74,MICHIGANSTATE,70,144
1957,KANSAS,80,SANFRANCISCO,56,136
1957,MORTHCAROLINA,54,KANSAS,53,107
1958,MARYLAND,86,BOSTONCOLLEGE,63,149
1958,MANHATTAN,89,WESTVIRGINIA,84,173
1958,DARTMOUTH,75,CONNECTICUT,64,139
1958,MIAMI(OHIO),82,PITTSBURGH,77,159
1958,NOTREDAME,94,TENNESSEETECH,61,155
1958,OKLAHOMASTATE,59,LOYOLA(N.O.),42,101
1958,SEATTLE,88,WYOMING,51,139
1958,IDAHOSTATE,72,ARIZONASTATE,68,140
1958,TEMPLE,71,MARYLAND,67,138
1958,DARTMOUTH,79,MANHATTAN,62,141
1958,KENTUCKY,94,MIAMI(OHIO),70,164
1958,NOTREDAME,94,INDIANA,87,181
1958,OKLAHOMASTATE,65,ARKANSAS,40,105
1958,KANSASSTATE,83,CINCINNATI,80,163
1958,SEATTLE,69,SANFRANCISCO,67,136
1958,CALIFORNIA,54,IDAHOSTATE,43,97
1958,TEMPLE,69,DARTMOUTH,50,119
1958,KENTUCKY,89,NOTREDAME,56,145
1958,KANSASSTATE,69,OKLAHOMASTATE,57,126
1958,SEATTLE,66,CALIFORNIA,62,128
1958,KENTUCKY,61,TEMPLE,60,121
1958,SEATTLE,73,KANSASSTATE,51,124
1958,KENTUCKY,84,SEATTLE,72,156
1959,WESTVIRGINIA,82,DARTMOUTH,68,150
1959,BOSTONUNIVERSITY,60,CONNECTICUT,58,118
1959,NAVY,76,NORTHCAROLINA,63,139
1959,LOUISVILLE,77,EASTERNKENTUCKY,63,140
1959,MARQUETTE,89,BOWLINGGREEN,71,160
1959,DEPAUL,57,PORTLAND,56,113
1959,IDAHOSTATE,62,NEWMEXICOSTATE,61,123
1959,WESTVIRGINIA,95,ST.JOSEPH'S,92,187
1959,BOSTONUNIVERSITY,62,NAVY,55,117
1959,LOUISVILLE,76,KENTUCKY,61,137
1959,MICHIGANSTATE,74,MARQUETTE,69,143
1959,KANSASSTATE,102,DEPAUL,70,172
1959,CINCINNATI,77,TCU,73,150
1959,ST.MARY'S,80,IDAHOSTATE,71,151
1959,CALIFORNIA,71,UTAH,53,124
1959,WESTVIRGINIA,86,BOSTONUNIVERSITY,82,168
1959,LOUISVILLE,88,MICHIGANSTATE,81,169
1959,CINCINNATI,85,KANSASSTATE,75,160
1959,CALIFORNIA,66,ST.MARY'S,46,112
1959,WESTVIRGINIA,94,LOUISVILLE,79,173
1959,CALIFORNIA,64,CINCINNATI,58,122
1959,CALIFORNIA,71,WESTVIRGINIA,70,141
1960,DUKE,84,PRINCETON,60,144
1960,WESTVIRGINIA,94,NAVY,86,180
1960,NYU,78,CONNECTICUT,59,137
1960,OHIO,74,NOTREDAME,66,140
1960,WESTERNKENTUCKY,107,MIAMI(FLA),84,191
1960,DEPAUL,69,AIRFORCE,63,132
1960,CALIFORNIA,71,IDAHOSTATE,44,115
1960,OREGON,68,NEWMEXICOSTATE,60,128
1960,UTAH,80,SOUTHERNCALIFORNIA,73,153
1960,DUKE,58,ST.JOSEPH'S,56,114
1960,NYU,82,WESTVIRGINIA,81,163
1960,GEORGIATECH,57,OHIO,54,111
1960,OHIOSTATE,98,WESTERNKENTUCKY,79,177
1960,CINCINNATI,99,DEPAUL,59,158
1960,KANSAS,90,TEXAS,81,171
1960,CALIFORNIA,69,SANTACLARA,49,118
1960,OREGON,65,UTAH,54,119
1960,NYU,74,DUKE,59,133
1960,OHIOSTATE,86,GEORGIATECH,69,155
1960,CINCINNATI,82,KANSAS,71,153
1960,CALIFORNIA,70,OREGON,49,119
1960,OHIOSTATE,76,NYU,54,130
1960,CALIFORNIA,77,CINCINNATI,69,146
1960,OHIOSTATE,75,CALIFORNIA,55,130
1961,PRINCETON,84,GEORGEWASHINGTON,67,151
1961,ST.BONAVENTURE,86,RHODEISLAND,76,162
1961,WAKEFOREST,97,ST.JOHN'S,74,171
1961,LOUISVILLE,76,OHIO,70,146
1961,MOREHEADSTATE,71,XAVIER(OHIO),66,137
1961,HOUSTON,77,MARQUETTE,61,138
1961,ARIZONASTATE,72,SEATTLE,70,142
1961,SOUTHERNCALIFORNIA,81,OREGON,79,160
1961,ST.JOSEPH'S,72,PRINCETON,67,139
1961,WAKEFOREST,78,ST.BONAVENTURE,73,151
1961,OHIOSTATE,56,LOUISVILLE,55,111
1961,KENTUCKY,71,MOREHEADSTATE,64,135
1961,KANSASSTATE,75,HOUSTON,64,139
1961,CINCINNATI,78,TEXASTECH,55,133
1961,ARIZONASTATE,86,SOUTHERNCALIFORNIA,71,157
1961,UTAH,91,LOYOLA-MARYMOUNT,75,166
1961,ST.JOSEPH'S,96,WAKEFOREST,86,182
1961,OHIOSTATE,87,KENTUCKY,74,161
1961,CINCINNATI,69,KANSASSTATE,64,133
1961,UTAH,88,ARIZONASTATE,80,168
1961,OHIOSTATE,95,ST.JOSEPH'S,69,164
1961,CINCINNATI,82,UTAH,67,149
1961,CINCINNATI,70,OHIOSTATE,65,135
1962,WAKEFOREST,92,YALE,82,174
1962,NYU,70,MASSACHUSETTS,50,120
1962,VILLANOVA,90,WESTVIRGINIA,75,165
1962,BUTLER,56,BOWLINGGREEN,55,111
1962,WESTERNKENTUCKY,90,DETROIT,81,171
1962,TEXASTECH,68,AIRFORCE,66,134
1962,CREIGHTON,87,MEMPHISSTATE,83,170
1962,OREGONSTATE,69,SEATTLE,65,134
1962,UTAHSTATE,78,ARIZONASTATE,73,151
1962,WAKEFOREST,96,ST.JOSEPH'S,85,181
1962,VILLANOVA,79,NYU,76,155
1962,KENTUCKY,81,BUTLER,60,141
1962,OHIOSTATE,93,WESTERNKENTUCKY,73,166
1962,COLORADO,67,TEXASTECH,60,127
1962,CINCINNATI,66,CREIGHTON,46,112
1962,OREGONSTATE,69,PEPPERDINE,67,136
1962,UCLA,73,UTAHSTATE,62,135
1962,WAKEFOREST,79,VILLANOVA,69,148
1962,OHIOSTATE,74,KENTUCKY,64,138
1962,CINCINNATI,73,COLORADO,46,119
1962,UCLA,88,OREGONSTATE,69,157
1962,OHIOSTATE,84,WAKEFOREST,68,152
1962,CINCINNATI,72,UCLA,70,142
1962,CINCINNATI,71,OHIOSTATE,59,130
1963,NYU,93,PITTSBURGH,83,176
1963,WESTVIRGINIA,77,CONNECTICUT,71,148
1963,ST.JOSEPH'S,82,PRINCETON,81,163
1963,BOWLINGGREEN,77,NOTREDAME,72,149
1963,LOYOLA-CHICAGO,111,TENNESSEETECH,42,153
1963,OKLAHOMACITY,70,COLORADOSTATE,67,137
1963,TEXAS,64,TEXAS-ELPASO,47,111
1963,ARIZONASTATE,79,UTAHSTATE,75,154
1963,OREGONSTATE,70,SEATTLE,67,137
1963,DUKE,81,NYU,76,157
1963,ST.JOSEPH'S,97,WESTVIRGINIA,88,185
1963,ILLINOIS,70,BOWLINGGREEN,67,137
1963,LOYOLA-CHICAGO,61,MISSISSIPPISTATE,51,112
1963,COLORADO,78,OKLAHOMACITY,72,150
1963,CINCINNATI,73,TEXAS,68,141
1963,ARIZONASTATE,93,UCLA,79,172
1963,OREGONSTATE,65,SANFRANCISCO,61,126
1963,DUKE,73,ST.JOSEPH'S,59,132
1963,LOYOLA-CHICAGO,79,ILLINOIS,64,143
1963,CINCINNATI,67,COLORADO,60,127
1963,OREGONSTATE,83,ARIZONASTATE,65,148
1963,LOYOLA-CHICAGO,94,DUKE,75,169
1963,CINCINNATI,80,OREGONSTATE,46,126
1963,LOYOLA-CHICAGO,60,CINCINNATI,58,118
1964,VILLANOVA,77,PROVIDENCE,66,143
1964,CONNECTICUT,53,TEMPLE,48,101
1964,PRINCETON,86,VMI,60,146
1964,OHIO,71,LOUISVILLE,69,140
1964,LOYOLA-CHICAGO,101,MURRAYSTATE,91,192
1964,CREIGHTON,89,OKLAHOMACITY,78,167
1964,TEXAS-ELPASO,68,TEXASA&M,62,130
1964,SEATTLE,61,OREGONSTATE,57,118
1964,UTAHSTATE,92,ARIZONASTATE,90,182
1964,DUKE,87,VILLANOVA,73,160
1964,CONNECTICUT,52,PRINCETON,50,102
1964,OHIO,85,KENTUCKY,69,154
1964,MICHIGAN,84,LOYOLA-CHICAGO,80,164
1964,WICHITASTATE,84,CREIGHTON,68,152
1964,KANSASSTATE,64,TEXAS-ELPASO,60,124
1964,UCLA,95,SEATTLE,90,185
1964,SANFRANCISCO,64,UTAHSTATE,58,122
1964,DUKE,101,CONNECTICUT,54,155
1964,MICHIGAN,69,OHIO,57,126
1964,KANSASSTATE,94,WICHITASTATE,86,180
1964,UCLA,76,SANFRANCISCO,72,148
1964,DUKE,91,MICHIGAN,80,171
1964,UCLA,90,KANSASSTATE,84,174
1964,UCLA,98,DUKE,83,181
1965,PRINCETON,60,PENNSTATE,58,118
1965,ST.JOSEPH'S,67,CONNECTICUT,61,128
1965,DAYTON,66,OHIO,65,131
1965,DEPAUL,99,EASTERNKENTUCKY,52,151
1965,HOUSTON,99,NOTREDAME,98,197
1965,OKLAHOMACITY,70,COLORADOSTATE,68,138
1965,PRINCETON,66,N.CAROLINASTATE,48,114
1965,PROVIDENCE,81,ST.JOSEPH'S,73,154
1965,MICHIGAN,98,DAYTON,71,169
1965,VANDERBILT,83,DEPAUL,78,161
1965,OKLAHOMASTATE,75,HOUSTON,60,135
1965,WICHITASTATE,86,SMU,81,167
1965,SANFRANCISCO,91,OKLAHOMACITY,67,158
1965,UCLA,100,BRIGHAMYOUNG,76,176
1965,PRINCETON,109,PROVIDENCE,69,178
1965,MICHIGAN,87,VANDERBILT,85,172
1965,WICHITASTATE,54,OKLAHOMASTATE,46,100
1965,UCLA,101,SANFRANCISCO,93,194
1965,MICHIGAN,93,PRINCETON,76,169
1965,UCLA,108,WICHITASTATE,89,197
1965,UCLA,91,MICHIGAN,80,171
1966,ST.JOSEPH'S,65,PROVIDENCE,48,113
1966,DAVIDSON,95,RHODEISLAND,65,160
1966,DAYTON,58,MIAMI(OHIO),51,109
1966,WESTERNKENTUCKY,105,LOYOLA-CHICAGO,86,191
1966,TEXAS-ELPASO,89,OKLAHOMACITY,74,163
1966,HOUSTON,82,COLORADOSTATE,76,158
1966,DUKE,76,ST.JOSEPH'S,74,150
1966,SYRACUSE,94,DAVIDSON,78,172
1966,KENTUCKY,86,DAYTON,79,165
1966,MICHIGAN,80,WESTERNKENTUCKY,79,159
1966,TEXAS-ELPASO,78,CINCINNATI,76,154
1966,KANSAS,76,SMU,70,146
1966,OREGONSTATE,63,HOUSTON,60,123
1966,UTAH,83,PACIFIC,74,157
1966,DUKE,91,SYRACUSE,81,172
1966,KENTUCKY,84,MICHIGAN,77,161
1966,TEXAS-ELPASO,81,KANSAS,80,161
1966,UTAH,70,OREGONSTATE,64,134
1966,KENTUCKY,83,DUKE,79,162
1966,TEXAS-ELPASO,85,UTAH,78,163
1966,TEXAS-ELPASO,72,KENTUCKY,65,137
1967,PRINCETON,68,WESTVIRGINIA,57,125
1967,ST.JOHN'S,57,TEMPLE,53,110
1967,BOSTONCOLLEGE,48,CONNECTICUT,42,90
1967,DAYTON,69,WESTERNKENTUCKY,67,136
1967,VIRGINIATECH,82,TOLEDO,76,158
1967,HOUSTON,59,NEWMEXICOSTATE,58,117
1967,TEXAS-ELPASO,62,SEATTLE,54,116
1967,NORTHCAROLINA,78,PRINCETON,70,148
1967,BOSTONCOLLEGE,63,ST.JOHN'S,62,125
1967,DAYTON,53,TENNESSEE,52,105
1967,VIRGINIATECH,79,INDIANA,70,149
1967,HOUSTON,66,KANSAS,53,119
1967,SMU,83,LOUISVILLE,81,164
1967,PACIFIC,72,TEXAS-ELPASO,63,135
1967,UCLA,109,WYOMING,60,169
1967,NORTHCAROLINA,96,BOSTONCOLLEGE,80,176
1967,DAYTON,71,VIRGINIATECH,66,137
1967,HOUSTON,83,SMU,75,158
1967,UCLA,80,PACIFIC,64,144
1967,DAYTON,76,NORTHCAROLINA,62,138
1967,UCLA,73,HOUSTON,58,131
1967,UCLA,79,DAYTON,64,143
1968,ST.BONAVENTURE,102,BOSTONCOLLEGE,93,195
1968,DAVIDSON,79,ST.JOHN'S,70,149
1968,COLUMBIA,83,LASALLE,69,152
1968,E.TENNESSEESTATE,79,FLORIDASTATE,69,148
1968,MARQUETTE,72,BOWLINGGREEN,71,143
1968,HOUSTON,94,LOYOLA-CHICAGO,76,170
1968,NEWMEXICOSTATE,68,WEBERSTATE,57,125
1968,NORTHCAROLINA,91,ST.BONAVENTURE,72,163
1968,DAVIDSON,61,COLUMBIA,59,120
1968,OHIOSTATE,79,E.TENNESSEESTATE,72,151
1968,KENTUCKY,107,MARQUETTE,89,196
1968,HOUSTON,91,LOUISVILLE,75,166
1968,TCU,77,KANSASSTATE,72,149
1968,UCLA,58,NEWMEXICOSTATE,49,107
1968,SANTACLARA,86,NEWMEXICO,73,159
1968,NORTHCAROLINA,70,DAVIDSON,66,136
1968,OHIOSTATE,82,KENTUCKY,81,163
1968,HOUSTON,103,TCU,68,171
1968,UCLA,87,SANTACLARA,66,153
1968,NORTHCAROLINA,80,OHIOSTATE,66,146
1968,UCLA,101,HOUSTON,69,170
1968,UCLA,78,NORTHCAROLINA,55,133
1969,DUQUESNE,74,ST.JOSEPH'S,52,126
1969,DAVIDSON,75,VILLANOVA,61,136
1969,ST.JOHN'S,72,PRINCETON,63,135
1969,MIAMI(OHIO),63,NOTREDAME,60,123
1969,MARQUETTE,82,MURRAYSTATE,62,144
1969,TEXASA&M,81,TRINITY,66,147
1969,COLORADOSTATE,52,DAYTON,50,102
1969,NEWMEXICOSTATE,74,BRIGHAMYOUNG,62,136
1969,WEBERSTATE,75,SEATTLE,73,148
1969,NORTHCAROLINA,79,DUQUESNE,78,157
1969,DAVIDSON,79,ST.JOHN'S,69,148
1969,PURDUE,91,MIAMI(OHIO),71,162
1969,MARQUETTE,81,KENTUCKY,74,155
1969,DRAKE,81,TEXASA&M,63,144
1969,COLORADOSTATE,64,COLORADO,56,120
1969,UCLA,53,NEWMEXICOSTATE,38,91
1969,SANTACLARA,63,WEBERSTATE,59,122
1969,NORTHCAROLINA,87,DAVIDSON,85,172
1969,PURDUE,75,MARQUETTE,73,148
1969,DRAKE,84,COLORADOSTATE,77,161
1969,UCLA,90,SANTACLARA,52,142
1969,PURDUE,92,NORTHCAROLINA,65,157
1969,UCLA,85,DRAKE,82,167
1969,UCLA,92,PURDUE,72,164
1970,ST.BONAVENTURE,85,DAVIDSON,72,157
1970,VILLANOVA,77,TEMPLE,69,146
1970,NIAGARA,79,PENNSYLVANIA,69,148
1970,JACKSONVILLE,109,WESTERNKENTUCKY,96,205
1970,NOTREDAME,112,OHIO,82,194
1970,NEWMEXICO,101,RICE,77,178
1970,HOUSTON,71,DAYTON,64,135
1970,LONGBEACHSTATE,92,WEBERSTATE,73,165
1970,UTAHSTATE,91,TEXAS-ELPASO,81,172
1970,ST.BONAVENTURE,80,N.CAROLINASTATE,68,148
1970,VILLANOVA,98,NIAGARA,73,171
1970,JACKSONVILLE,104,IOWA,103,207
1970,KENTUCKY,109,NOTREDAME,99,208
1970,NEWMEXICO,70,KANSASSTATE,66,136
1970,DRAKE,92,HOUSTON,87,179
1970,UCLA,88,LONGBEACHSTATE,65,153
1970,UTAHSTATE,69,SANTACLARA,68,137
1970,ST.BONAVENTURE,97,VILLANOVA,74,171
1970,JACKSONVILLE,106,KENTUCKY,100,206
1970,NEWMEXICO,87,DRAKE,78,165
1970,UCLA,101,UTAHSTATE,79,180
1970,JACKSONVILLE,91,ST.BONAVENTURE,83,174
1970,UCLA,93,NEWMEXICO,77,170
1970,UCLA,80,JACKSONVILLE,69,149
1971,VILLANOVA,93,ST.JOSEPH'S,75,168
1971,FORDHAM,105,FURMAN,74,179
1971,PENNSYLVANIA,70,DUQUESNE,65,135
1971,WESTERNKENTUCKY,74,JACKSONVILLE,72,146
1971,MARQUETTE,62,MIAMI(OHIO),47,109
1971,HOUSTON,72,NEWMEXICOSTATE,69,141
1971,NOTREDAME,102,TCU,94,196
1971,BRIGHAMYOUNG,91,UTAHSTATE,82,173
1971,LONGBEACHSTATE,77,WEBERSTATE,66,143
1971,VILLANOVA,85,FORDHAM,75,160
1971,PENNSYLVANIA,79,SOUTHCAROLINA,64,143
1971,WESTENKENTUCKY,107,KENTUCKY,83,190
1971,OHIOSTATE,60,MARQUETTE,59,119
1971,KANSAS,78,HOUSTON,77,155
1971,DRAKE,79,NOTREDAME,72,151
1971,UCLA,91,BRIGHAMYOUNG,73,164
1971,LONGBEACHSTATE,78,PACIFIC,65,143
1971,VILLANOVA,90,PENNSYLVANIA,47,137
1971,WESTERNKENTUCKY,81,OHIOSTATE,78,159
1971,KANSAS,73,DRAKE,71,144
1971,UCLA,57,LONGBEACHSTATE,55,112
1971,VILLANOVA,92,WESTERNKENTUCKY,89,181
1971,UCLA,68,KANSAS,60,128
1971,UCLA,68,VILLANOVA,62,130
1972,FLORIDASTATE,83,EASTERNKENTUCKY,81,164
1972,MARQUETTE,73,OHIO,49,122
1972,SOUTHCAROLINA,53,TEMPLE,51,104
1972,PENNSYLVANIA,76,PROVIDENCE,60,136
1972,VILLANOVA,85,EASTCAROLINA,70,155
1972,SWLOUISIANA,112,MARSHALL,101,213
1972,TEXAS,85,HOUSTON,74,159
1972,WEBERSTATE,91,HAWAII,64,155
1972,LONGBEACHSTATE,95,BRIGHAMYOUNG,90,185
1972,FLORIDASTATE,70,MINNESOTA,56,126
1972,KENTUCKY,85,MARQUETTE,69,154
1972,NORTHCAROLINA,92,SOUTHCAROLINA,69,161
1972,PENNSYLVANIA,78,VILLANOVA,67,145
1972,LOUISVILLE,88,SWLOUISIANA,84,172
1972,KANSASSTATE,66,TEXAS,55,121
1972,UCLA,90,WEBERSTATE,58,148
1972,LONGBEACHSTATE,75,SANFRANCISCO,55,130
1972,FLORIDASTATE,73,KENTUCKY,54,127
1972,NORTHCAROLINA,73,PENNSYLVANIA,59,132
1972,LOUISVILLE,72,KANSASSTATE,65,137
1972,UCLA,73,LONGBEACHSTATE,57,130
1972,FLORIDASTATE,79,NORTHCAROLINA,75,154
1972,UCLA,96,LOUISVILLE,77,173
1972,UCLA,81,FLORIDASTATE,76,157
1973,SOUTHCAROLINA,78,TEXASTECH,70,148
1973,SWLOUISIANA,102,HOUSTON,89,191
1973,PROVIDENCE,89,ST.JOSEPH'S,76,165
1973,PENNSYLVANIA,62,ST.JOHN'S,61,123
1973,SYRACUSE,83,FURMAN,82,165
1973,MARQUETTE,77,MIAMI(OHIO),62,139
1973,AUSTINPEAY,77,JACKSONVILLE,75,152
1973,ARIZONASTATE,103,OKLAHOMACITY,78,181
1973,LONGBEACHSTATE,88,WEBERSTATE,75,163
1973,MEMPHISSTATE,90,SOUTHCAROLINA,76,166
1973,KANSASSTATE,66,SWLOUISIANA,63,129
1973,PROVIDENCE,87,PENNSYLVANIA,65,152
1973,MARYLAND,91,SYRACUSE,75,166
1973,INDIANA,75,MARQUETTE,69,144
1973,KENTUCKY,106,AUSTINPEAY,100,206
1973,UCLA,98,ARIZONASTATE,81,179
1973,SANFRANCISCO,77,LONGBEACHSTATE,67,144
1973,MEMPHISSTATE,92,KANSASSTATE,72,164
1973,PROVIDENCE,103,MARYLAND,89,192
1973,INDIANA,72,KENTUCKY,65,137
1973,UCLA,54,SANFRANCISCO,39,93
1973,MEMPHISSTATE,98,PROVIDENCE,85,183
1973,UCLA,70,INDIANA,59,129
1973,UCLA,87,MEMPHISSTATE,66,153
1974,PROVIDENCE,84,PENNSYLVANIA,69,153
1974,PITTSBURGH,54,ST.JOSEPH'S,42,96
1974,FURMAN,75,SOUTHCAROLINA,67,142
1974,DAYTON,88,CALSTATE-LA,80,168
1974,NEWMEXICO,73,IDAHOSTATE,65,138
1974,MARQUETTE,85,OHIO,59,144
1974,NOTREDAME,108,AUSTINPEAY,66,174
1974,CREIGHTON,77,TEXAS,61,138
1974,ORALROBERTS,86,SYRACUSE,82,168
1974,N.CAROLINASTATE,92,PROVIDENCE,78,170
1974,PITTSBURGH,81,FURMAN,78,159
1974,UCLA,111,DAYTON,100,211
1974,SANFRANCISCO,64,NEWMEXICO,61,125
1974,MARQUETTE,69,VANDERBILT,61,130
1974,MICHIGAN,77,NOTREDAME,68,145
1974,KANSAS,55,CREIGHTON,54,109
1974,ORALROBERTS,96,LOUISVILLE,93,189
1974,N.CAROLINASTATE,100,PITTSBURGH,72,172
1974,UCLA,83,SANFRANCISCO,60,143
1974,MARQUETTE,72,MICHIGAN,70,142
1974,KANSAS,93,ORALROBERTS,90,183
1974,N.CAROLINASTATE,80,UCLA,77,157
1974,MARQUETTE,64,KANSAS,51,115
1974,N.CAROLINASTATE,76,MARQUETTE,64,140
1975,UCLA,103,MICHIGAN,91,194
1975,MONTANA,69,UTAHSTATE,63,132
1975,ARIZONASTATE,97,ALABAMA,94,191
1975,UNLV,90,SANDIEGOSTATE,80,170
1975,MARYLAND,83,CREIGHTON,79,162
1975,NOTREDAME,77,KANSAS,71,148
1975,CINCINNATI,87,TEXASA&M,79,166
1975,LOUISVILLE,91,RUTGERS,78,169
1975,SYRACUSE,87,LASALLE,83,170
1975,NORTHCAROLINA,93,NEWMEXICOSTATE,69,162
1975,KANSASSTATE,69,PENNSYLVANIA,62,131
1975,BOSTONCOLLEGE,82,FURMAN,76,158
1975,INDIANA,78,TEXAS-ELPASO,53,131
1975,OREGONSTATE,78,M.TENNESSEESTATE,67,145
1975,CENTRALMICHIGAN,77,GEORGETOWN,75,152
1975,KENTUCKY,76,MARQUETTE,64,140
1975,UCLA,67,MONTANA,64,131
1975,ARIZONASTATE,84,UNLV,81,165
1975,MARYLAND,83,NOTREDAME,71,154
1975,LOUISVILLE,78,CINCINNATI,63,141
1975,SYRACUSE,78,NORTHCAROLINA,76,154
1975,KANSASSTATE,74,BOSTONCOLLEGE,65,139
1975,INDIANA,81,OREGONSTATE,71,152
1975,KENTUCKY,90,CENTRALMICHIGAN,73,163
1975,UCLA,89,ARIZONASTATE,75,164
1975,LOUISVILLE,96,MARYLAND,82,178
1975,SYRACUSE,95,KANSASSTATE,87,182
1975,KENTUCKY,92,INDIANA,90,182
1975,UCLA,75,LOUISVILLE,74,149
1975,KENTUCKY,95,SYRACUSE,79,174
1975,UCLA,92,KENTUCKY,85,177
1976,DEPAUL,69,VIRGINIA,60,129
1976,VMI,81,TENNESSEE,75,156
1976,RUTGERS,54,PRINCETON,53,107
1976,CONNECTICUT,80,HOFSTRA,78,158
1976,MICHIGAN,74,WICHITASTATE,73,147
1976,NOTREDAME,79,CINCINNATI,78,157
1976,MISSOURI,69,WASHINGTON,67,136
1976,TEXASTECH,69,SYRACUSE,56,125
1976,ALABAMA,79,NORTHCAROLINA,64,143
1976,INDIANA,90,ST.JOHN'S,70,160
1976,MARQUETTE,79,WESTERNKENTUCKY,60,139
1976,WESTERNMICHIGAN,77,VIRGINIATECH,67,144
1976,PEPPERDINE,87,MEMPHISSTATE,77,164
1976,UCLA,74,SANDIEGOSTATE,64,138
1976,UNLV,103,BOISESTATE,78,181
1976,ARIZONA,83,GEORGETOWN,76,159
1976,VMI,71,DEPAUL,66,137
1976,RUTGERS,93,CONNECTICUT,79,172
1976,MICHIGAN,80,NOTREDAME,76,156
1976,MISSOURI,86,TEXASTECH,75,161
1976,INDIANA,74,ALABAMA,69,143
1976,MARQUETTE,62,WESTERNMICHIGAN,57,119
1976,UCLA,70,PEPPERDINE,61,131
1976,ARIZONA,114,UNLV,109,223
1976,RUTGERS,91,VMI,75,166
1976,MICHIGAM,95,MISSOURI,88,183
1976,INDIANA,65,MARQUETTE,56,121
1976,UCLA,82,ARIZONA,66,148
1976,MICHIGAN,86,RUTGERS,70,156
1976,INDIANA,65,UCLA,51,116
1976,INDIANA,86,MICHIGAN,68,154
1977,VMI,73,DUQUESNE,66,139
1977,KENTUCKY,72,PRINCETON,58,130
1977,NOTREDAME,90,HOFSTRA,83,173
1977,NORTHCAROLINA,69,PURDUE,66,135
1977,UCLA,87,LOUISVILLE,79,166
1977,IDAHOSTATE,83,LONGBEACHSTATE,72,155
1977,UTAH,72,ST.JOHN'S,68,140
1977,UNLV,121,SANFRANCISCO,95,216
1977,MICHIGAN,92,HOLYCROSS,81,173
1977,DETROIT,93,M.TENNESSEESTATE,76,169
1977,N.C.-CHARLOTTE,91,CENTRALMICHIGAN,86,177
1977,SYRACUSE,93,TENNESSEE,88,181
1977,MARQUETTE,66,CINCINNATI,51,117
1977,KANSASSTATE,87,PROVIDENCE,80,167
1977,WAKEFOREST,86,ARKANSAS,80,166
1977,SOUTHERNILLINOIS,81,ARIZONA,77,158
1977,KENTUCKY,93,VMI,78,171
1977,NORTHCAROLINA,79,NOTREDAME,77,156
1977,IDAHOSTATE,76,UCLA,75,151
1977,UNLV,88,UTAH,83,171
1977,MICHIGAN,86,DETROIT,81,167
1977,N.C.-CHARLOTTE,81,SYRACUSE,59,140
1977,MARQUETTE,67,KANSASSTATE,66,133
1977,WAKEFOREST,86,SOUTHERNILLINOIS,81,167
1977,NORTHCAROLINA,79,KENTUCKY,72,151
1977,UNLV,107,IDAHOSTATE,90,197
1977,N.C.-CHARLOTTE,75,MICHIGAN,68,143
1977,MARQUETTE,82,WAKEFOREST,68,150
1977,NORTHCAROLINA,84,UNLV,83,167
1977,MARQUETTE,51,N.C.-CHARLOTTE,49,100
1977,MARQUETTE,67,NORTHCAROLINA,59,126
1978,MICHIGANSTATE,77,PROVIDENCE,63,140
1978,WESTERNKENTUCKY,87,SYRACUSE,86,173
1978,MIAMI(OHIO),84,MARQUETTE,81,165
1978,KENTUCKY,85,FLORIDASTATE,76,161
1978,UCLA,83,KANSAS,76,159
1978,ARKANSAS,73,WEBERSTATE,52,125
1978,SANFRANCISCO,68,NORTHCAROLINA,64,132
1978,CALSTATE-FULLERTON,90,NEWMEXICO,85,175
1978,DUKE,63,RHODEISLAND,62,125
1978,PENNSYLVANIA,92,ST.BONAVENTURE,83,175
1978,INDIANA,63,FURMAN,62,125
1978,VILLANOVA,103,LASALLE,97,200
1978,UTAH,86,MISSOURI,79,165
1978,NOTREDAME,100,HOUSTON,77,177
1978,DEPAUL,80,CREIGHTON,78,158
1978,LOUISVILLE,76,ST.JOHN'S,68,144
1978,MICHIGANSTATE,90,WESTERNKENTUCKY,69,159
1978,KENTUCKY,91,MIAMI(OHIO),69,160
1978,ARKANSAS,74,UCLA,70,144
1978,CALSTATE-FULLERTON,75,SANFRANCISCO,72,147
1978,DUKE,84,PENNSYLVANIA,80,164
1978,VILLANOVA,61,INDIANA,60,121
1978,NOTREDAME,69,UTAH,56,125
1978,DEPAUL,90,LOUISVILLE,89,179
1978,KENTUCKY,52,MICHIGANSTATE,49,101
1978,ARKANSAS,61,CALSTATE-FULLERTON,58,119
1978,DUKE,90,VILLANOVA,72,162
1978,NOTREDAME,84,DEPAUL,64,148
1978,KENTUCKY,64,ARKANSAS,59,123
1978,DUKE,90,NOTREDAME,86,176
1978,KENTUCKY,94,DUKE,88,182
1979,ST.JOHN'S,75,TEMPLE,70,145
1979,PENNSYLVANIA,73,IONA,69,142
1979,LAMAR,95,DETROIT,87,182
1979,TENNESSEE,97,EASTERNKENTUCKY,81,178
1979,SOUTHERNCALIFORNIA,86,UTAHSTATE,67,153
1979,PEPPERDINE,92,UTAH,88,180
1979,WEBERSTATE,81,NEWMEXICOSTATE,78,159
1979,VIRGINIATECH,70,JACKSONVILLE,53,123
1979,ST.JOHN'S,80,DUKE,78,158
1979,RUTGERS,64,GEORGETOWN,58,122
1979,PENNSYLVANIA,72,NORTHCAROLINA,71,143
1979,SYRACUSE,89,CONNECTICUT,81,170
1979,MICHIGANSTATE,95,LAMAR,64,159
1979,LSU,71,APPALACHIANSTATE,57,128
1979,NOTREDAME,73,TENNESSEE,67,140
1979,TOLEDO,74,IOWA,72,146
1979,DEPAUL,89,SOUTHERNCALIFORNIA,78,167
1979,MARQUETTE,73,PACIFIC,48,121
1979,UCLA,76,PEPPERDINE,71,147
1979,SANFRANCISCO,86,BRIGHAMYOUNG,63,149
1979,ARKANSAS,74,WEBERSTATE,63,137
1979,LOUISVILLE,69,SOUTHALABAMA,66,135
1979,INDIANASTATE,86,VIRGINIATECH,69,155
1979,OKLAHOMA,90,TEXAS,76,166
1979,ST.JOHN'S,67,RUTGERS,65,132
1979,PENNSYLVANIA,84,SYRACUSE,76,160
1979,MICHIGANSTATE,87,LSU,71,158
1979,NOTREDAME,79,TOLEDO,71,150
1979,DEPAUL,62,MARQUETTE,56,118
1979,UCLA,99,SANFRANCISCO,81,180
1979,ARKANSAS,73,LOUISVILLE,62,135
1979,INDIANASTATE,93,OKLAHOMA,72,165
1979,PENNSYLVANIA,64,ST.JOHN'S,62,126
1979,MICHIGANSTATE,80,NOTREDAME,68,148
1979,DEPAUL,95,UCLA,91,186
1979,INDIANASTATE,73,ARKANSAS,71,144
1979,MICHIGANSTATE,101,PENNSYLVANIA,67,168
1979,INDIANASTATE,76,DEPAUL,74,150
1979,MICHIGANSTATE,75,INDIANASTATE,64,139
1980,VILLANOVA,77,MARQUETTE,59,136
1980,IOWA,86,VCU,72,158
1980,IONA,84,HOLYCROSS,78,162
1980,TENNESSEE,80,FURMAN,69,149
1980,ALCORNSTATE,70,SOUTHALABAMA,62,132
1980,MISSOURI,61,SANJOSESTATE,51,112
1980,TEXASA&M,55,BRADLEY,53,108
1980,KANSASSTATE,71,ARKANSAS,53,124
1980,FLORIDASTATE,94,TOLEDO,91,185
1980,PENNSYLVANIA,62,WASHINGTONSTATE,55,117
1980,PURDUE,90,LASALLE,82,172
1980,VIRGINIATECH,89,WESTERNKENTUCKY,85,174
1980,UCLA,87,OLDDOMINION,74,161
1980,ARIZONASTATE,99,LOYOLA-MARYMOUNT,71,170
1980,CLEMSON,76,UTAHSTATE,73,149
1980,LAMAR,87,WEBERSTATE,86,173
1980,SYRACUSE,97,VILLANOVA,83,180
1980,IOWA,77,N.CAROLINASTATE,64,141
1980,GEORGETOWN,74,IONA,71,145
1980,MARYLAND,86,TENNESSEE,75,161
1980,LSU,98,ALCORNSTATE,88,186
1980,MISSOURI,87,NOTREDAME,84,171
1980,TEXASA&M,78,NORTHCAROLINA,61,139
1980,LOUISVILLE,71,KANSASSTATE,69,140
1980,KENTUCKY,97,FLORIDASTATE,78,175
1980,DUKE,52,PENNSYLVANIA,42,94
1980,PURDUE,87,ST.JOHN'S,72,159
1980,INDIANA,68,VIRGINIATECH,59,127
1980,UCLA,77,DEPAUL,71,148
1980,OHIOSTATE,89,ARIZONASTATE,75,164
1980,CLEMSON,71,BRIGHAMYOUNG,66,137
1980,LAMAR,81,OREGONSTATE,77,158
1980,IOWA,88,SYRACUSE,77,165
1980,GEORGETOWN,74,MARYLAND,68,142
1980,LSU,68,MISSOURI,63,131
1980,LOUISVILLE,66,TEXASA&M,55,121
1980,DUKE,55,KENTUCKY,54,109
1980,PURDUE,76,INDIANA,69,145
1980,UCLA,72,OHIOSTATE,68,140
1980,CLEMSON,74,LAMAR,66,140
1980,IOWA,81,GEORGETOWN,80,161
1980,LOUISVILLE,86,LSU,66,152
1980,PURDUE,68,DUKE,60,128
1980,UCLA,85,CLEMSON,74,159
1980,LOUISVILLE,80,IOWA,72,152
1980,UCLA,67,PURDUE,62,129
1980,LOUISVILLE,59,UCLA,54,113
1981,LAMAR,71,MISSOURI,67,138
1981,ARKANSAS,73,MERCER,67,140
1981,WICHITASTATE,95,SOUTHERN-B.R.,70,165
1981,KANSAS,69,MISSISSIPPI,66,135
1981,ST.JOSEPH'S,59,CREIGHTON,57,116
1981,BOSTONCOLLEGE,93,BALLSTATE,90,183
1981,MARYLAND,81,TENNESSEE-CHAT,69,150
1981,ALABAMA-BIRMINGHAM,93,WESTERNKENTUCKY,68,161
1981,KANSASSTATE,64,SANFRANCISCO,60,124
1981,WYOMING,78,HOWARD,43,121
1981,NOTHEASTERN,55,FRESNOSTATE,53,108
1981,PITTSBUGH,70,IDAHO,69,139
1981,VILLANOVA,90,HOUSTON,72,162
1981,VCU,85,LONGISLAND,69,154
1981,BRIGHAMYOUNG,60,PRINCETON,51,111
1981,JAMESMADISON,61,GEORGETOWN,55,116
1981,LSU,100,LAMAR,78,178
1981,ARKANSAS,74,LOUISVILLE,73,147
1981,WICHITASTATE,60,IOWA,56,116
1981,KANSAS,88,ARIZONASTATE,71,159
1981,ST.JOSEPH'S,49,DEPAUL,48,97
1981,BOSTONCOLLEGE,67,WAKEFOREST,64,131
1981,INDIANA,99,MARYLAND,64,163
1981,ALABAMA-BIRMINGHAM,69,KENTUCKY,62,131
1981,KANSASSTATE,50,OREGONSTATE,48,98
1981,ILLINOIS,67,WYOMING,65,132
1981,UTAH,94,NORTHEASTERN,69,163
1981,NORTHCAROLINA,74,PITTSBURGH,57,131
1981,VIRGINIA,54,VILLANOVA,50,104
1981,TENNESSEE,58,VCU,56,114
1981,BRIGHAMYOUNG,78,UCLA,55,133
1981,NOTREDAME,54,JAMESMADISON,45,99
1981,LSU,72,ARKANSAS,56,128
1981,WICHITASTATE,66,KANSAS,65,131
1981,ST.JOSEPH'S,42,BOSTONCOLLEGE,41,83
1981,INDIANA,87,ALABAMA-BIRMINGHAM,72,159
1981,KANSASSTATE,57,ILLINOIS,52,109
1981,NORTHCAROLINA,61,UTAH,56,117
1981,VIRGINIA,62,TENNESSEE,48,110
1981,BRIGHAMYOUNG,51,NOTREDAME,50,101
1981,LSU,96,WICHITASTATE,85,181
1981,INDIANA,78,ST.JOSEPH'S,46,124
1981,NORTHCAROLINA,82,KANSASSTATE,68,150
1981,VIRGINIA,74,BRIGHAMYOUNG,60,134
1981,INDIANA,67,LSU,49,116
1981,NORTHCAROLINA,78,VIRGINIA,65,143
1981,INDIANA,63,NORTHCAROLINA,50,113
1982,JAMESMADISON,55,OHIOSTATE,48,103
1982,ST.JOHN'S,66,PENNSYLVANIA,56,122
1982,NORTHEASTERN,63,ST.JOSEPH'S,62,125
1982,WAKEFOREST,74,OLDDOMINION,57,131
1982,BOSTONCOLLEGE,70,SANFRANCISCO,66,136
1982,KANSASSTATE,77,NORTHERNILLINOIS,68,145
1982,HOUSTON,94,ALCORNSTATE,84,178
1982,MARQUETTE,67,EVANSVILLE,62,129
1982,TENNESSEE,61,SWLOUISIANA,57,118
1982,INDIANA,94,ROBERTMORRIS,62,156
1982,M.TENNESSEESTATE,50,KENTUCKY,44,94
1982,TENNESSEE-CHAT,58,N.CAROLINASTATE,51,109
1982,WYOMING,61,SOUTHERNCALIFORNIA,58,119
1982,WESTVIRGINIA,102,NORTHCAROLINAA&T,72,174
1982,IOWA,70,NELOUISIANA,63,133
1982,PEPPERDINE,99,PITTSBURGH,88,187
1982,NORTHCAROLINA,52,JAMESMADISON,50,102
1982,ALABAMA,69,ST.JOHN'S,68,137
1982,VILLANOVA,76,NORTHEASTERN,72,148
1982,MEMPHISSTATE,56,WAKEFOREST,55,111
1982,BOSTONCOLLEGE,82,DEPAUL,75,157
1982,KANSASSTATE,65,ARKANSAS,64,129
1982,HOUSTON,78,TULSA,74,152
1982,MISSOURI,73,MARQUETTE,69,142
1982,VIRGINIA,54,TENNESSEE,51,105
1982,ALABAMA-BIRMINGHAM,80,INDIANA,70,150
1982,LOUISVILLE,81,M.TENNESSEESTATE,56,137
1982,MINNESOTA,62,TENNESSEE-CHAT,61,123
1982,GEORGETOWN,51,WYOMING,43,94
1982,FRESNOSTATE,50,WESTVIRGINIA,46,96
1982,IDAHO,69,IOWA,67,136
1982,OREGONSTATE,70,PEPPERDINE,51,121
1982,NORTHCAROLINA,74,ALABAMA,69,143
1982,VILLANOVA,70,MEMPHISSTATE,66,136
1982,BOSTONCOLLEGE,69,KANSASSTATE,65,134
1982,HOUSTON,79,MISSOURI,78,157
1982,ALABAMA-BIRMINGHAM,68,VIRGINIA,66,134
1982,LOUISVILLE,67,MINNESOTA,61,128
1982,GEORGETOWN,58,FRESNOSTATE,40,98
1982,OREGONSTATE,60,IDAHO,42,102
1982,NORTHCAROLINA,70,VILLANOVA,60,130
1982,HOUSTON,99,BOSTONCOLLEGE,92,191
1982,LOUISVILLE,75,ALABAMA-BIRMINGHAM,68,143
1982,GEORGETOWN,69,OREGONSTATE,45,114
1982,NORTHCAROLINA,68,HOUSTON,63,131
1982,GEORGETOWN,50,LOUISVILLE,46,96
1982,NORTHCAROLINA,63,GEORGETOWN,62,125
1983,MARYLAND,52,TENNESSEE-CHAT,51,103
1983,GEORGETOWN,68,ALCORNSTATE,63,131
1983,LAMAR,73,ALABAMA,50,123
1983,IOWA,64,UTAHSTATE,59,123
1983,TENNESSEE,57,MARQUETTE,56,113
1983,PURDUE,55,ROBERTMORRIS,53,108
1983,OHIO,51,ILLINOISSTATE,49,100
1983,OKLAHOMA,71,ALABAMA-BIRMINGHAM,63,134
1983,WASHINGTONSTATE,62,WEBERSTATE,52,114
1983,PRINCETON,56,OKLAHOMASTATE,53,109
1983,N.CAROLINASTATE,69,PEPPERDINE,67,136
1983,UTAH,52,ILLINOIS,49,101
1983,RUTGERS,60,SWLOUISIANA,53,113
1983,VCU,76,LASALLE,67,143
1983,SYRACUSE,74,MOREHEADSTATE,59,133
1983,JAMESMADISON,57,WESTVIRGINIA,50,107
1983,HOUSTON,60,MARYLAND,50,110
1983,MEMPHISSTATE,66,GEORGETOWN,57,123
1983,VILLANOVA,60,LAMAR,58,118
1983,IOWA,77,MISSOURI,63,140
1983,LOUISVILLE,70,TENNESSEE,57,127
1983,ARKANSAS,78,PURDUE,68,146
1983,KENTUCKY,57,OHIO,40,97
1983,INDIANA,63,OKLAHOMA,49,112
1983,VIRGINIA,54,WASHINGTONSTATE,49,103
1983,BOSTONCOLLEGE,51,PRINCETON,42,93
1983,N.CAROLINASTATE,71,UNLV,70,141
1983,UTAH,67,UCLA,61,128
1983,ST.JOHN'S,66,RUTGERS,55,121
1983,GEORGIA,56,VCU,54,110
1983,OHIOSTATE,79,SYRACUSE,74,153
1983,NORTHCAROLINA,68,JAMESMADISON,49,117
1983,HOUSTON,70,MEMPHISSTATE,63,133
1983,VILLANOVA,55,IOWA,54,109
1983,LOUISVILLE,65,ARKANSAS,63,128
1983,KENTUCKY,64,INDIANA,59,123
1983,VIRGINIA,95,BOSTONCOLLEGE,92,187
1983,N.CAROLINASTATE,75,UTAH,56,131
1983,GEORGIA,70,ST.JOHN'S,67,137
1983,NORTHCAROLINA,64,OHIOSTATE,51,115
1983,HOUSTON,89,VILLANOVA,71,160
1983,LOUISVILLE,80,KENTUCKY,68,148
1983,N.CAROLINASTATE,63,VIRGINIA,62,125
1983,GEORGIA,82,NORTHCAROLINA,77,159
1983,HOUSTON,94,LOUISVILLE,81,175
1983,N.CAROLINASTATE,67,GEORGIA,60,127
1983,N.CAROLINASTATE,54,HOUSTON,52,106
1984,BRIGHAMYOUNG,84,ALABAMA-BIRMINGHAM,68,152
1984,LOUISVILLE,72,MOREHEADSTATE,59,131
1984,WESTVIRGINIA,64,OREGONSTATE,62,126
1984,VILLANOVA,84,MARSHALL,72,156
1984,SMU,83,MIAMI(OHIO),69,152
1984,UNLV,68,PRINCETON,56,124
1984,WASHINGTON,64,NEVADA-RENO,54,118
1984,DAYTON,74,LSU,66,140
1984,TEMPLE,65,ST.JOHN'S,63,128
1984,RICHMOND,72,AUBURN,71,143
1984,VCU,70,NORTHEASTERN,69,139
1984,VIRGINIA,58,IONA,57,115
1984,ILLINOISSTATE,49,ALABAMA,48,97
1984,KANSAS,57,ALCORNSTATE,56,113
1984,MEMPHISSTATE,92,ORALROBERTS,83,175
1984,LOUISIANATECH,66,FRESNOSTATE,56,122
1984,KENTUCKY,93,BRIGHAMYOUNG,68,161
1984,LOUISVILLE,69,TULSA,67,136
1984,MARYLAND,102,WESTVIRGINIA,77,179
1984,ILLINOIS,64,VILLANOVA,56,120
1984,GEORGETOWN,37,SMU,36,73
1984,UNLV,73,TEXAS-ELPASO,60,133
1984,WASHINGTON,80,DUKE,78,158
1984,DAYTON,89,OKLAHOMA,85,174
1984,NORTHCAROLINA,77,TEMPLE,66,143
1984,INDIANA,75,RICHMOND,67,142
1984,SYRACUSE,78,VCU,63,141
1984,VIRGINIA,53,ARKANSAS,51,104
1984,DEPAUL,75,ILLINOISSTATE,61,136
1984,WAKEFOREST,69,KANSAS,59,128
1984,MEMPHISSTATE,66,PURDUE,48,114
1984,HOUSTON,77,LOUISIANATECH,69,146
1984,KENTUCKY,72,LOUISVILLE,67,139
1984,ILLINOIS,72,MARYLAND,70,142
1984,GEORGETOWN,62,UNLV,48,110
1984,DAYTON,64,WASHINGTON,58,122
1984,INDIANA,72,NORTHCAROLINA,68,140
1984,VIRGINIA,63,SYRACUSE,55,118
1984,WAKEFOREST,73,DEPAUL,71,144
1984,HOUSTON,78,MEMPHISSTATE,71,149
1984,KENTUCKY,54,ILLINOIS,51,105
1984,GEORGETOWN,61,DAYTON,49,110
1984,VIRGINIA,50,INDIANA,48,98
1984,HOUSTON,68,WAKEFOREST,63,131
1984,GEORGETOWN,53,KENTUCKY,40,93
1984,HOUSTON,49,VIRGINIA,47,96
1984,GEORGETOWN,84,HOUSTON,75,159
1985,ST.JOHN'S,83,SOUTHERN-B.R.,59,142
1985,ARKANSAS,63,IOWA,54,117
1985,KENTUCKY,66,WASHINGTON,58,124
1985,TEXAS-ELPASO,79,TULSA,75,154
1985,N.CAROLINASTATE,65,NEVADA-RENO,56,121
1985,ALABAMA,50,ARIZONA,41,91
1985,VCU,81,MARSHALL,65,146
1985,GEORGETOWN,68,LEHIGH,43,111
1985,TEMPLE,60,VIRGINIATECH,57,117
1985,SMU,85,OLDDOMINION,68,153
1985,LOYOLA-CHICAGO,59,IONA,58,117
1985,GEORGIA,67,WICHITASTATE,59,126
1985,ILLINOIS,76,NORTHEASTERN,57,133
1985,SYRACUSE,70,DEPAUL,65,135
1985,GEORGIATECH,65,MERCER,58,123
1985,OKLAHOMA,96,NORTHCAROLINAA&T,83,179
1985,ILLINOISSTATE,58,SOUTHERNCALIFORNIA,55,113
1985,LOUISIANATECH,78,PITTSBURGH,54,132
1985,OHIOSTATE,75,IOWASTATE,64,139
1985,BOSTONCOLLEGE,55,TEXASTECH,53,108
1985,DUKE,75,PEPPERDINE,62,137
1985,ALABAMA-BIRMINGHAM,70,MICHIGANSTATE,68,138
1985,MEMPHISSTATE,67,PENNSYLVANIA,55,122
1985,MICHIGAN,59,FAIRLEIGHDICKINSON,55,114
1985,VILLANOVA,51,DAYTON,49,100
1985,MARYLAND,69,MIAMI(OHIO),68,137
1985,NAVY,78,LSU,55,133
1985,AUBURN,59,PURDUE,58,117
1985,KANSAS,49,OHIO,38,87
1985,NOTREDAME,79,OREGONSTATE,70,149
1985,NORTHCAROLINA,76,M.TENNESSEESTATE,57,133
1985,ST.JOHN'S,68,ARKANSAS,65,133
1985,KENTUCKY,64,UNLV,61,125
1985,N.CAROLINASTATE,86,TEXAS-ELPASO,73,159
1985,ALABAMA,63,VCU,59,122
1985,GEORGETOWN,63,TEMPLE,46,109
1985,LOYOLA-CHICAGO,70,SMU,57,127
1985,ILLINOIS,74,GEORGIA,58,132
1985,GEORGIATECH,70,SYRACUSE,53,123
1985,OKLAHOMA,75,ILLINOISSTATE,69,144
1985,LOUISIANATECH,79,OHIOSTATE,67,146
1985,BOSTONCOLLEGE,74,DUKE,73,147
1985,MEMPHISSTATE,67,ALABAMA-BIRMINGHAM,66,133
1985,VILLANOVA,59,MICHIGAN,55,114
1985,MARYLAND,64,NAVY,59,123
1985,AUBURN,66,KANSAS,64,130
1985,NORTHCAROLINA,60,NOTREDAME,58,118
1985,ST.JOHN'S,86,KENTUCKY,70,156
1985,N.CAROLINASTATE,61,ALABAMA,55,116
1985,GEORGETOWN,65,LOYOLA-CHICAGO,53,118
1985,GEORGIATECH,61,ILLINOIS,53,114
1985,OKLAHOMA,86,LOUISIANATECH,84,170
1985,MEMPHISSTATE,59,BOSTONCOLLEGE,57,116
1985,VILLANOVA,46,MARYLAND,43,89
1985,NORTHCAROLINA,62,AUBURN,56,118
1985,ST.JOHN'S,69,N.CAROLINASTATE,60,129
1985,GEORGETOWN,60,GEORGIATECH,54,114
1985,MEMPHISSTATE,63,OKLAHOMA,61,124
1985,VILLANOVA,56,NORTHCAROLINA,44,100
1985,GEORGETOWN,77,ST.JOHN'S,59,136
1985,VILLANOVA,52,MEMPHISSTATE,45,97
1985,VILLANOVA,66,GEORGETOWN,64,130
1986,KENTUCKY,75,DAVIDSON,55,130
1986,WESTERNKENTUCKY,67,NEBRASKA,59,126
1986,ALABAMA,97,XAVIER,80,177
1986,ILLINOIS,75,FAIRFIELD,51,126
1986,LSU,94,PURDUE,87,181
1986,MEMPHISSTATE,95,BALLSTATE,63,158
1986,VILLANOVA,71,VIRGINIATECH,62,133
1986,GEORGIATECH,68,MARIST,53,121
1986,ST.JOHN'S,83,MONTANASTATE,74,157
1986,AUBURN,73,ARIZONA,63,136
1986,MARYLAND,69,PEPPERDINE,64,133
1986,UNLV,74,NELOUISIANA,51,125
1986,ALABAMA-BIRMINGHAM,66,MISSOURI,64,130
1986,NORTHCAROLINA,84,UTAH,72,156
1986,BRADLEY,83,TEXAS-ELPASO,65,148
1986,LOUISVILLE,93,DREXEL,73,166
1986,DUKE,85,MISS.VALLEYSTATE,78,163
1986,OLDDOMINION,72,WESTVIRGINIA,64,136
1986,DEPAUL,72,VIRGINIA,68,140
1986,OKLAHOMA,80,NORTHEASTERN,74,154
1986,ST.JOSEPH'S,60,RICHMOND,59,119
1986,CLEVELANDSTATE,83,INDIANA,79,162
1986,NAVY,87,TULSA,68,155
1986,SYRACUSE,101,BROWN,52,153
1986,KANSAS,71,NORTHCAROLINAA&T,46,117
1986,TEMPLE,61,JACKSONVILLE,50,111
1986,MICHIGANSTATE,72,WASHINGTON,70,142
1986,GEORGETOWN,70,TEXASTECH,64,134
1986,N.CAROLINASTATE,66,IOWA,64,130
1986,ARKANSAS-L.R.,90,NOTREDAME,83,173
1986,IOWASTATE,81,MIAMI(OHIO),79,160
1986,MICHIGAN,70,AKRON,64,134
1986,KENTUCKY,71,WESTERNKENTUCKY,64,135
1986,ALABAMA,58,ILLINOIS,56,114
1986,LSU,83,MEMPHISSTATE,81,164
1986,GEORGIATECH,66,VILLANOVA,61,127
1986,AUBURN,81,ST.JOHN'S,65,146
1986,UNLV,70,MARYLAND,64,134
1986,NORTHCAROLINA,77,ALABAMA-BIRMINGHAM,59,136
1986,LOUISVILLE,82,BRADLEY,68,150
1986,DUKE,89,OLDDOMINION,61,150
1986,DEPAUL,74,OKLAHOMA,69,143
1986,CLEVELANDSTATE,75,ST.JOSEPH'S,69,144
1986,NAVY,97,SYRACUSE,85,182
1986,KANSAS,65,TEMPLE,43,108
1986,MICHIGANSTATE,80,GEORGETOWN,68,148
1986,N.CAROLINASTATE,80,ARKANSAS-L.R.,66,146
1986,IOWA,72,MICHIGAN,69,141
1986,KENTUCKY,68,ALABAMA,63,131
1986,LSU,70,GEORGIATECH,64,134
1986,AUBURN,70,UNLV,63,133
1986,LOUISVILLE,94,NORTHCAROLINA,79,173
1986,DUKE,74,DEPAUL,67,141
1986,NAVY,71,CLEVELANDSTATE,70,141
1986,KANSAS,96,MICHIGANSTATE,86,182
1986,N.CAROLINASTATE,70,IOWASTATE,66,136
1986,LSU,59,KENTUCKY,57,116
1986,LOUISVILLE,84,AUBURN,76,160
1986,DUKE,71,NAVY,50,121
1986,KANSAS,75,N.CAROLINASTATE,67,142
1986,LOUISVILLE,88,LSU,77,165
1986,DUKE,71,KANSAS,67,138
1986,LOUISVILLE,72,DUKE,69,141
1987,UNLV,95,IDAHOSTATE,70,165
1987,KANSASSTATE,82,GEORGIA,79,161
1987,WYOMING,64,VIRGINIA,60,124
1987,UCLA,92,CENTRALMICHIGAN,73,165
1987,OKLAHOMA,74,TULSA,69,143
1987,PITTSBURGH,93,MARIST,68,161
1987,TEXAS-ELPASO,98,ARIZONA,91,189
1987,IOWA,99,SANTACLARA,76,175
1987,INDIANA,92,FAIRFIELD,58,150
1987,AUBURN,62,SANDIEGO,61,123
1987,DUKE,58,TEXASA&M,51,109
1987,XAVIER(OHIO),70,MISSOURI,69,139
1987,ST.JOHN'S,57,WICHITASTATE,55,112
1987,DEPAUL,76,LOUISIANATECH,62,138
1987,LSU,85,GEORGIATECH,79,164
1987,TEMPLE,75,SOUTHERN-B.R.,56,131
1987,GEORGETOWN,75,BUCKNELL,53,128
1987,OHIOSTATE,91,KENTUCKY,77,168
1987,KANSAS,66,HOUSTON,55,121
1987,SWMISSOURISTATE,65,CLEMSON,60,125
1987,PROVIDENCE,90,ALABAMA-BIRMINGHAM,68,158
1987,AUSTINPEAY,68,ILLINOIS,67,135
1987,NEWORLEANS,83,BRIGHAMYOUNG,79,162
1987,ALABAMA,88,NORTHCAROLINAA&T,71,159
1987,NORTHCAROLINA,113,PENNSYLVANIA,82,195
1987,MICHIGAN,97,NAVY,82,179
1987,NOTREDAME,84,M.TENNESSEESTATE,71,155
1987,TCU,76,MARSHALL,70,146
1987,FLORIDA,82,N.CAROLINASTATE,70,152
1987,PURDUE,104,NORTHEASTERN,95,199
1987,WESTERNKENTUCKY,64,WESTVIRGINIA,62,126
1987,SYRACUSE,79,GEORGIASOUTHERN,73,152
1987,UNLV,80,KANSASSTATE,61,141
1987,WYOMING,78,UCLA,68,146
1987,OKLAHOMA,96,PITTSBURGH,93,189
1987,IOWA,84,TEXAS-ELPASO,82,166
1987,INDIANA,107,AUBURN,90,197
1987,DUKE,65,XAVIER(OHIO),60,125
1987,DEPAUL,83,ST.JOHN'S,75,158
1987,LSU,72,TEMPLE,62,134
1987,GEORGETOWN,82,OHIOSTATE,79,161
1987,KANSAS,67,SWMISSOURISTATE,63,130
1987,PROVIDENCE,90,AUSTINPEAY,87,177
1987,ALABAMA,101,NEWORLEANS,76,177
1987,NORTHCAROLINA,109,MICHIGAN,97,206
1987,NOTREDAME,58,TCU,57,115
1987,FLORIDA,85,PURDUE,66,151
1987,SYRACUSE,104,WESTERNKENTUCKY,86,190
1987,UNLV,92,WYOMING,78,170
1987,IOWA,93,OKLAHOMA,91,184
1987,INDIANA,88,DUKE,82,170
1987,LSU,63,DEPAUL,58,121
1987,GEORGETOWN,70,KANSAS,57,127
1987,PROVIDENCE,103,ALABAMA,82,185
1987,NORTHCAROLINA,74,NOTREDAME,68,142
1987,SYRACUSE,87,FLORIDA,81,168
1987,UNLV,84,IOWA,81,165
1987,INDIANA,77,LSU,76,153
1987,PROVIDENCE,88,GEORGETOWN,73,161
1987,SYRACUSE,79,NORTHCAROLINA,75,154
1987,INDIANA,97,UNLV,93,190
1987,SYRACUSE,77,PROVIDENCE,63,140
1987,INDIANA,74,SYRACUSE,73,147
1988,PURDUE,94,FAIRLEIGHDICKINSON,79,173
1988,MEMPHISSTATE,75,BAYLOR,60,135
1988,DEPAUL,83,WICHITASTATE,62,145
1988,KANSASSTATE,66,LASALLE,53,119
1988,KANSAS,85,XAVIER(OHIO),72,157
1988,MURRAYSTATE,78,N.CAROLINASTATE,75,153
1988,VANDERBILT,80,UTAHSTATE,77,157
1988,PITTSBURGH,108,EASTERNMICHIGAN,90,198
1988,TEMPLE,87,LEHIGH,73,160
1988,GEORGETOWN,66,LSU,63,129
1988,GEORGIATECH,90,IOWASTATE,78,168
1988,RICHMOND,72,INDIANA,69,141
1988,RHODEISLAND,87,MISSOURI,80,167
1988,SYRACUSE,69,NORTHCAROLINAA&T,55,124
1988,SMU,83,NOTREDAME,75,158
1988,DUKE,85,BOSTONUNIVERSITY,69,154
1988,ARIZONA,90,CORNELL,50,140
1988,SETONHALL,80,TEXAS-ELPASO,64,144
1988,IOWA,102,FLORIDASTATE,98,200
1988,UNLV,54,SWMISSOURISTATE,50,104
1988,FLORIDA,62,ST.JOHN'S,59,121
1988,MICHIGAN,63,BOISESTATE,58,121
1988,LOYOLA-MARYMOUNT,119,WYOMING,115,234
1988,NORTHCAROLINA,83,NORTHTEXASSTATE,65,148
1988,OKLAHOMA,94,TENNESSEE-CHAT,66,160
1988,AUBURN,90,BRADLEY,86,176
1988,LOUISVILLE,70,OREGONSTATE,61,131
1988,BRIGHAMYOUNG,98,N.C.-CHARLOTTE,92,190
1988,VILLANOVA,82,ARKANSAS,74,156
1988,ILLINOIS,81,TEXAS-SANANTONIO,72,153
1988,MARYLAND,92,UC-SANTABARBARA,82,174
1988,KENTUCKY,99,SOUTHERN-B.R.,84,183
1988,PURDUE,100,MEMPHISSTATE,73,173
1988,KANSASSTATE,66,DEPAUL,58,124
1988,KANSAS,61,MURRAYSTATE,58,119
1988,VANDERBILT,80,PITTSBURGH,74,154
1988,TEMPLE,74,GEORGETOWN,53,127
1988,RICHMOND,59,GEORGIATECH,55,114
1988,RHODEISLAND,97,SYRACUSE,94,191
1988,DUKE,94,SMU,79,173
1988,ARIZONA,84,SETONHALL,55,139
1988,IOWA,104,UNLV,86,190
1988,MICHIGAN,108,FLORIDA,85,193
1988,NORTHCAROLINA,123,LOYOLA-MARYMOUNT,97,220
1988,OKLAHOMA,107,AUBURN,87,194
1988,LOUISVILLE,97,BRIGHAMYOUNG,76,173
1988,VILLANOVA,66,ILLINOIS,63,129
1988,KENTUCKY,90,MARYLAND,81,171
1988,KANSASSTATE,73,PURDUE,70,143
1988,KANSAS,77,VANDERBILT,64,141
1988,TEMPLE,69,RICHMOND,47,116
1988,DUKE,73,RHODEISLAND,72,145
1988,ARIZONA,99,IOWA,79,178
1988,NORTHCAROLINA,78,MICHIGAN,69,147
1988,OKLAHOMA,108,LOUISVILLE,98,206
1988,VILLANOVA,80,KENTUCKY,74,154
1988,KANSAS,71,KANSASSTATE,58,129
1988,DUKE,63,TEMPLE,53,116
1988,ARIZONA,70,NORTHCAROLINA,52,122
1988,OKLAHOMA,78,VILLANOVA,59,137
1988,KANSAS,66,DUKE,59,125
1988,OKLAHOMA,86,ARIZONA,78,164
1988,KANSAS,83,OKLAHOMA,79,162
1989,ILLINOIS,77,MCNEESESTATE,71,148
1989,BALLSTATE,68,PITTSBURGH,64,132
1989,ARKANSAS,120,LOYOLA-MARYMOUNT,101,221
1989,LOUISVILLE,76,ARKANSAS-L.R.,71,147
1989,TEXAS,76,GEORGIATECH,70,146
1989,MISSOURI,85,CREIGHTON,69,154
1989,COLORADOSTATE,68,FLORIDA,46,114
1989,SYRACUSE,104,BUCKNELL,81,185
1989,OKLAHOMA,72,E.TENNESSEESTATE,71,143
1989,LOUISIANATECH,88,LASALLE,74,162
1989,VIRGINIA,100,PROVIDENCE,97,197
1989,M.TENNESSEESTATE,97,FLORIDASTATE,83,180
1989,SOUTHALABAMA,86,ALABAMA,84,170
1989,MICHIGAN,92,XAVIER(OHIO),87,179
1989,UCLA,84,IOWASTATE,74,158
1989,NORTHCAROLINA,93,SOUTHERN-B.R.,79,172
1989,GEORGETOWN,50,PRINCETON,49,99
1989,NOTREDAME,81,VANDERBILT,65,146
1989,N.CAROLINASTATE,81,SOUTHCAROLINA,66,147
1989,IOWA,87,RUTGERS,73,160
1989,MINNESOTA,86,KANSASSTATE,75,161
1989,SIENA,80,STANFORD,78,158
1989,WESTVIRGINIA,84,TENNESSEE,68,152
1989,DUKE,90,S.CAROLINASTATE,69,159
1989,ARIZONA,94,ROBERTMORRIS,60,154
1989,CLEMSON,83,ST.MARY'S,70,153
1989,DEPAUL,66,MEMPHISSTATE,63,129
1989,UNLV,68,IDAHO,56,124
1989,EVANSVILLE,94,OREGONSTATE,90,184
1989,SETONHALL,60,SWMISSOURISTATE,51,111
1989,TEXAS-ELPASO,85,LSU,74,159
1989,INDIANA,99,GEORGEMASON,85,184
1989,ILLINOIS,72,BALLSTATE,60,132
1989,LOUISVILLE,93,ARKANSAS,84,177
1989,MISSOURI,108,TEXAS,89,197
1989,SYRACUSE,65,COLORADOSTATE,50,115
1989,OKLAHOMA,124,LOUISIANATECH,81,205
1989,VIRGINIA,104,M.TENNESSEESTATE,88,192
1989,MICHIGAN,91,SOUTHALABAMA,82,173
1989,NORTHCAROLINA,88,UCLA,81,169
1989,GEORGETOWN,81,NOTREDAME,74,155
1989,N.CAROLINASTATE,102,IOWA,96,198
1989,MINNESOTA,80,SIENA,67,147
1989,DUKE,70,WESTVIRGINIA,63,133
1989,ARIZONA,94,CLEMSON,68,162
1989,UNLV,85,DEPAUL,70,155
1989,SETONHALL,87,EVANSVILLE,73,160
1989,INDIANA,92,TEXAS-ELPASO,69,161
1989,ILLINOIS,83,LOUISVILLE,69,152
1989,SYRACUSE,83,MISSOURI,80,163
1989,VIRGINIA,86,OKLAHOMA,80,166
1989,MICHIGAN,92,NORTHCAROLINA,87,179
1989,GEORGETOWN,69,N.CAROLINASTATE,61,130
1989,DUKE,87,MINNESOTA,70,157
1989,UNLV,68,ARIZONA,67,135
1989,SETONHALL,78,INDIANA,65,143
1989,ILLINOIS,89,SYRACUSE,86,175
1989,MICHIGAN,102,VIRGINIA,65,167
1989,DUKE,85,GEORGETOWN,77,162
1989,SETONHALL,84,UNLV,61,145
1989,MICHIGAN,83,ILLINOIS,81,164
1989,SETONHALL,95,DUKE,78,173
1989,MICHIGAN,80,SETONHALL,79,159
1990,MICHIGANSTATE,75,MURRAYSTATE,71,146
1990,UC-SANTABARBARA,70,HOUSTON,66,136
1990,LSU,70,VILLANOVA,63,133
1990,MINNESOTA,64,TEXAS-ELPASO,61,125
1990,NORTHERNIOWA,74,MISSOURI,71,145
1990,VIRGINIA,75,NOTREDAME,67,142
1990,SYRACUSE,70,COPPINSTATE,48,118
1990,UNLV,102,ARKANSAS-L.R.,72,174
1990,OHIOSTATE,84,PROVIDENCE,83,167
1990,BALLSTATE,54,OREGONSTATE,53,107
1990,IDAHO,89,LOUISVILLE,78,167
1990,LOYOLA-MARYMOUNT,111,NEWMEXICOSTATE,92,203
1990,MICHIGAN,76,ILLINOISSTATE,70,146
1990,ALABAMA,71,COLORADOSTATE,54,125
1990,ARIZONA,79,SOUTHFLORIDA,67,146
1990,CONNECTICUT,76,BOSTONUNIVERSITY,52,128
1990,CALIFORNIA,65,INDIANA,63,128
1990,CLEMSON,49,BRIGHAMYOUNG,47,96
1990,LASALLE,79,SOUTHERNMISS,63,142
1990,ST.JOHN'S,81,TEMPLE,65,146
1990,DUKE,81,RICHMOND,46,127
1990,UCLA,68,ALABAMA-BIRMINGHAM,56,124
1990,KANSAS,79,ROBERTMORRIS,71,150
1990,OKLAHOMA,77,TOWSONSTATE,68,145
1990,NORTHCAROLINA,83,SWMISSOURISTATE,70,153
1990,DAYTON,88,ILLINOIS,86,174
1990,ARKANSAS,68,PRINCETON,64,132
1990,XAVIER,87,KANSASSTATE,79,166
1990,GEORGETOWN,70,TEXASSOUTHERN,52,122
1990,TEXAS,100,GEORGIA,88,188
1990,PURDUE,75,NELOUISIANA,63,138
1990,MICHIGANSTATE,62,UC-SANTABARBARA,58,120
1990,GEORGIATECH,94,LSU,91,185
1990,MINNESOTA,81,NORTHERNIOWA,78,159
1990,SYRACUSE,63,VIRGINIA,61,124
1990,UNLV,76,OHIOSTATE,65,141
1990,BALLSTATE,62,LOUISVILLE,60,122
1990,LOYOLA-MARYMOUNT,149,MICHIGAN,115,264
1990,ALABAMA,77,ARIZONA,55,132
1990,CONNECTICUT,74,CALIFORNIA,54,128
1990,CLEMSON,79,LASALLE,75,154
1990,DUKE,76,ST.JOHN'S,72,148
1990,UCLA,71,KANSAS,70,141
1990,NORTHCAROLINA,79,OKLAHOMA,77,156
1990,ARKANSAS,86,DAYTON,84,170
1990,XAVIER,74,GEORGETOWN,71,145
1990,TEXAS,73,PURDUE,72,145
1990,GEORGIATECH,81,MICHIGANSTATE,80,161
1990,MINNESOTA,82,SYRACUSE,75,157
1990,UNLV,69,BALLSTATE,67,136
1990,LOYOLA-MARYMOUNT,62,ALABAMA,60,122
1990,CONNECTICUT,71,CLEMSON,70,141
1990,DUKE,90,UCLA,81,171
1990,ARKANSAS,96,NORTHCAROLINA,73,169
1990,TEXAS,102,XAVIER,89,191
1990,GEORGIATECH,93,MINNESOTA,91,184
1990,UNLV,131,LOYOLA-MARYMOUNT,101,232
1990,DUKE,79,CONNECTICUT,78,157
1990,ARKANSAS,88,TEXAS,85,173
1990,UNLV,90,GEORGIATECH,81,171
1990,DUKE,97,ARKANSAS,83,180
1990,UNLV,103,DUKE,73,176
1991,UNLV,99,MONTANA,65,164
1991,GEORGETOWN,79,VANDERBILT,60,139
1991,MICHIGANSTATE,60,WISCONSIN-GREENBAY,58,118
1991,UTAH,82,SOUTHALABAMA,72,154
1991,CREIGHTON,64,NEWMEXICOSTATE,56,120
1991,SETONHALL,71,PEPPERDINE,51,122
1991,BRIGHAMYOUNG,61,VIRGINIA,48,109
1991,ARIZONA,93,ST.FRANCIS-PA,80,173
1991,OHIOSTATE,97,TOWSONSTATE,86,183
1991,GEORGIATECH,87,DEPAUL,70,157
1991,TEXAS,73,ST.PETER'S,65,138
1991,ST.JOHN'S,75,NORTHERNILLINOIS,68,143
1991,CONNECTICUT,79,LSU,62,141
1991,XAVIER-OHIO,89,NEBRASKA,84,173
1991,IOWA,76,E.TENNESSEESTATE,73,149
1991,DUKE,102,NELOUISIANA,73,175
1991,NORTHCAROLINA,101,NORTHEASTERN,66,167
1991,VILLANOVA,50,PRINCETON,48,98
1991,EASTERNMICHIGAN,76,MISSISSIPPISTATE,56,132
1991,PENNSTATE,74,UCLA,69,143
1991,N.CAROLINASTATE,114,SOUTHERNMISS,85,199
1991,OKLAHOMASTATE,67,NEWMEXICO,54,121
1991,TEMPLE,80,PURDUE,63,143
1991,RICHMOND,73,SYRACUSE,69,142
1991,ARKANSAS,117,GEORGIASTATE,76,193
1991,ARIZONASTATE,79,RUTGERS,76,155
1991,WAKEFOREST,71,LOUISIANATECH,65,136
1991,ALABAMA,89,MURRAYSTATE,79,168
1991,PITTSBURGH,76,GEORGIA,68,144
1991,KANSAS,55,NEWORLEANS,49,104
1991,FLORIDASTATE,75,SOUTHERNCALIFORNIA,72,147
1991,INDIANA,79,COASTALCAROLINA,69,148
1991,UNLV,62,GEORGETOWN,54,116
1991,UTAH,85,MICHIGANSTATE,84,169
1991,SETONHALL,81,CREIGHTON,69,150
1991,ARIZONA,76,BRIGHAMYOUNG,61,137
1991,OHIOSTATE,65,GEORGIATECH,61,126
1991,ST.JOHN'S,84,TEXAS,76,160
1991,CONNECTICUT,66,XAVIER-OHIO,50,116
1991,DUKE,85,IOWA,70,155
1991,NORTHCAROLINA,84,VILLANOVA,69,153
1991,EASTERNMICHIGAN,71,PENNSTATE,68,139
1991,OKLAHOMASTATE,73,N.CAROLINASTATE,64,137
1991,TEMPLE,77,RICHMOND,64,141
1991,ARKANSAS,97,ARIZONASTATE,90,187
1991,ALABAMA,96,WAKEFOREST,88,184
1991,KANSAS,77,PITTSBURGH,66,143
1991,INDIANA,82,FLORIDASTATE,60,142
1991,UNLV,83,UTAH,66,149
1991,SETONHALL,81,ARIZONA,77,158
1991,ST.JOHN'S,91,OHIOSTATE,74,165
1991,DUKE,81,CONNECTICUT,67,148
1991,NORTHCAROLINA,93,EASTERNMICHIGAN,67,160
1991,TEMPLE,72,OKLAHOMASTATE,63,135
1991,ARKANSAS,93,ALABAMA,70,163
1991,KANSAS,83,INDIANA,65,148
1991,UNLV,77,SETONHALL,65,142
1991,DUKE,78,ST.JOHN'S,61,139
1991,NORTHCAROLINA,75,TEMPLE,72,147
1991,KANSAS,93,ARKANSAS,81,174
1991,DUKE,79,UNLV,77,156
1991,KANSAS,79,NORTHCAROLINA,73,152
1991,DUKE,72,KANSAS,65,137
1992,KANSAS,100,HOWARD,67,167
1992,TEXAS-ELPASO,55,EVANSVILLE,50,105
1992,MICHIGANSTATE,61,SWMISSOURISTATE,54,115
1992,CINCINNATI,85,DELAWARE,47,132
1992,MEMPHISSTATE,80,PEPPERDINE,70,150
1992,ARKANSAS,80,MURRAYSTATE,69,149
1992,GEORGIATECH,65,HOUSTON,60,125
1992,SOUTHERNCALIFORNIA,84,NELOUISIANA,54,138
1992,OHIOSTATE,83,MISS.VALLEYSTATE,56,139
1992,CONNECTICUT,86,NEBRASKA,65,151
1992,ALABAMA,80,STANFORD,75,155
1992,NORTHCAROLINA,68,MIAMI(OHIO),63,131
1992,MICHIGAN,73,TEMPLE,66,139
1992,E.TENNESSEESTATE,87,ARIZONA,80,167
1992,TULANE,61,ST.JOHN'S,57,118
1992,OKLAHOMASTATE,100,GEORGIASOUTHERN,73,173
1992,DUKE,82,CAMPBELL,56,138
1992,IOWA,98,TEXAS,92,190
1992,MISSOURI,89,WESTVIRGINIA,78,167
1992,SETONHALL,78,LASALLE,76,154
1992,SYRACUSE,51,PRINCETON,43,94
1992,MASSACHUSETTS,85,FORDHAM,58,143
1992,IOWASTATE,76,N.C.-CHARLOTTE,74,150
1992,KENTUCKY,88,OLDDOMINION,69,157
1992,UCLA,73,ROBERTMORRIS,53,126
1992,LOUISVILLE,81,WAKEFOREST,58,139
1992,NEWMEXICOSTATE,81,DEPAUL,73,154
1992,SWLOUISIANA,87,OKLAHOMA,83,170
1992,GEORGETOWN,75,SOUTHFLORIDA,60,135
1992,FLORIDASTATE,78,MONTANA,68,146
1992,LSU,94,BRIGHAMYOUNG,83,177
1992,INDIANA,94,EASTERNILLINOIS,55,149
1992,TEXAS-ELPASO,66,KANSAS,60,126
1992,CINCINNATI,77,MICHIGANSTATE,65,142
1992,MEMPHISSTATE,82,ARKANSAS,80,162
1992,GEORGIATECH,79,SOUTHERNCALIFORNIA,78,157
1992,OHIOSTATE,78,CONNECTICUT,55,133
1992,NORTHCAROLINA,64,ALABAMA,55,119
1992,MICHIGAN,102,E.TENNESSEESTATE,90,192
1992,OKLAHOMASTATE,87,TULANE,71,158
1992,DUKE,75,IOWA,62,137
1992,SETONHALL,88,MISSOURI,71,159
1992,MASSACHUSETTS,77,SYRACUSE,71,148
1992,KENTUCKY,106,IOWASTATE,98,204
1992,UCLA,85,LOUISVILLE,69,154
1992,NEWMEXICOSTATE,81,SWLOUISIANA,73,154
1992,FLORIDASTATE,78,GEORGETOWN,68,146
1992,INDIANA,89,LSU,79,168
1992,CINCINNATI,69,TEXAS-ELPASO,67,136
1992,MEMPHISSTATE,83,GEORGIATECH,79,162
1992,OHIOSTATE,80,NORTHCAROLINA,73,153
1992,MICHIGAN,75,OKLAHOMASTATE,72,147
1992,DUKE,81,SETONHALL,69,150
1992,KENTUCKY,87,MASSACHUSETTS,77,164
1992,UCLA,85,NEWMEXICOSTATE,78,163
1992,INDIANA,85,FLORIDASTATE,74,159
1992,CINCINNATI,88,MEMPHISSTATE,57,145
1992,MICHIGAN,75,OHIOSTATE,71,146
1992,DUKE,104,KENTUCKY,103,207
1992,INDIANA,106,UCLA,79,185
1992,MICHIGAN,76,CINCINNATI,72,148
1992,DUKE,81,INDIANA,78,159
1992,DUKE,71,MICHIGAN,51,122
1993,KENTUCKY,96,RIDER,52,148
1993,UTAH,86,PITTSBURGH,65,151
1993,WAKEFOREST,81,TENNESSEE-CHAT,58,139
1993,IOWA,82,NELOUISIANA,69,151
1993,TULANE,55,KANSASSTATE,53,108
1993,FLORIDASTATE,82,EVANSVILLE,70,152
1993,WESTERNKENTUCKY,55,MEMPHISSTATE,52,107
1993,SETONHALL,81,TENNESSEESTATE,59,140
1993,MICHIGAN,84,COASTALCAROLINA,53,137
1993,UCLA,81,IOWASTATE,70,151
1993,GEORGEWASHINGTON,82,NEWMEXICO,68,150
1993,SOUTHERN,93,GEORGIATECH,78,171
1993,ILLINOIS,75,LONGBEACHSTATE,72,147
1993,VANDERBILT,92,BOISESTATE,72,164
1993,TEMPLE,75,MISSOURI,61,136
1993,SANTACLARA,64,ARIZONA,61,125
1993,NORTHCAROLINA,85,EASTCAROLINA,65,150
1993,RHODEISLAND,74,PURDUE,68,142
1993,ST.JOHN'S,85,TEXASTECH,67,152
1993,ARKANSAS,94,HOLYCROSS,64,158
1993,VIRGINIA,78,MANHATTAN,66,144
1993,MASSACHUSETTS,54,PENNSYLVANIA,50,104
1993,NEWMEXICOSTATE,93,NEBRASKA,79,172
1993,CINCINNATI,93,COPPINSTATE,66,159
1993,INDIANA,97,WRIGHTSTATE,54,151
1993,XAVIER(OHIO),73,NEWORLEANS,55,128
1993,OKLAHOMASTATE,74,MARQUETTE,62,136
1993,LOUISVILLE,76,DELAWARE,70,146
1993,CALIFORNIA,66,LSU,64,130
1993,DUKE,105,SOUTHERNILLINOIS,70,175
1993,BRIGHAMYOUNG,80,SMU,71,151
1993,KANSAS,94,BALLSTATE,72,166
1993,KENTUCKY,83,UTAH,62,145
1993,WAKEFOREST,84,IOWA,78,162
1993,FLORIDASTATE,94,TULANE,63,157
1993,WESTERNKENTUCKY,72,SETONHALL,68,140
1993,MICHIGAN,86,UCLA,84,170
1993,GEORGEWASHINGTON,90,SOUTHERN,80,170
1993,VANDERBILT,85,ILLINOIS,68,153
1993,TEMPLE,68,SANTACLARA,57,125
1993,NORTHCAROLINA,112,RHODEISLAND,67,179
1993,ARKANSAS,80,ST.JOHN'S,74,154
1993,VIRGINIA,71,MASSACHUSETTS,56,127
1993,CINCINNATI,92,NEWMEXICOSTATE,55,147
1993,INDIANA,73,XAVIER(OHIO),55,128
1993,LOUISVILLE,78,OKLAHOMASTATE,63,141
1993,CALIFORNIA,82,DUKE,77,159
1993,KANSAS,90,BRIGHAMYOUNG,76,166
1993,KENTUCKY,103,WAKEFOREST,69,172
1993,FLORIDASTATE,81,WESTERNKENTUCKY,78,159
1993,MICHIGAN,72,GEORGEWASHINGTON,64,136
1993,TEMPLE,67,VANDERBILT,59,126
1993,NORTHCAROLINA,80,ARKANSAS,74,154
1993,CINCINNATI,71,VIRGINIA,54,125
1993,INDIANA,82,LOUISVILLE,69,151
1993,KANSAS,93,CALIFORNIA,76,169
1993,KENTUCKY,106,FLORIDASTATE,81,187
1993,MICHIGAN,77,TEMPLE,72,149
1993,NORTHCAROLINA,75,CINCINNATI,68,143
1993,KANSAS,83,INDIANA,77,160
1993,MICHIGAN,81,KENTUCKY,78,159
1993,NORTHCAROLINA,78,KANSAS,68,146
1993,NORTHCAROLINA,77,MICHIGAN,71,148
1994,CONNECTICUT,64,RIDER,46,110
1994,GEORGEWASHINGTON,51,ALABAMA-BIRMINGHAM,46,97
1994,PENNSYLVANIA,90,NEBRASKA,80,170
1994,FLORIDA,64,JAMESMADISON,62,126
1994,NORTHCAROLINA,71,LIBERTY,51,122
1994,BOSTONCOLLEGE,67,WASHINGTONSTATE,64,131
1994,TEMPLE,61,DREXEL,39,100
1994,INDIANA,84,OHIO,72,156
1994,WAKEFOREST,68,COLLEGECHARLESTON,58,126
1994,KANSAS,102,TENNESSEE-CHAT,73,175
1994,PURDUE,98,CENTRALFLORIDA,67,165
1994,ALABAMA,76,PROVIDENCE,70,146
1994,MARQUETTE,81,SWLOUISIANA,59,140
1994,KENTUCKY,83,TENNESSEESTATE,70,153
1994,DUKE,82,TEXASSOUTHERN,70,152
1994,MICHIGANSTATE,84,SETONHALL,73,157
1994,MARYLAND,74,ST.LOUIS,66,140
1994,MASSACHUSETTS,78,SWTEXASSTATE,60,138
1994,MICHIGAN,78,PEPPERDINE,74,152
1994,TEXAS,91,WESTERNKENTUCKY,77,168
1994,OKLAHOMASTATE,65,NEWMEXICOSTATE,55,120
1994,TULSA,112,UCLA,102,214
1994,GEORGETOWN,84,ILLINOIS,77,161
1994,ARKANSAS,94,NORTHCAROLINAA&T,79,173
1994,SYRACUSE,92,HAWAII,78,170
1994,WISCONSIN-GB,61,CALIFORNIA,57,118
1994,MISSOURI,76,NAVY,53,129
1994,WISCONSIN,80,CINCINNATI,72,152
1994,VIRGINIA,57,NEWMEXICO,54,111
1994,ARIZONA,81,LOYOLA-MARYLAND,55,136
1994,LOUISVILLE,67,BOISESTATE,58,125
1994,MINNESOTA,74,SOUTHERNILLINOIS,60,134
1994,CONNECTICUT,75,GEORGEWASHINGTON,63,138
1994,FLORIDA,70,PENNSYLVANIA,58,128
1994,INDIANA,67,TEMPLE,58,125
1994,BOSTONCOLLEGE,75,NORTHCAROLINA,72,147
1994,PURDUE,83,ALABAMA,73,156
1994,KANSAS,69,WAKEFOREST,58,127
1994,MARQUETTE,75,KENTUCKY,63,138
1994,DUKE,85,MICHIGANSTATE,74,159
1994,MARYLAND,95,MASSACHUSETTS,87,182
1994,MICHIGAN,84,TEXAS,79,163
1994,TULSA,82,OKLAHOMASTATE,80,162
1994,ARKANSAS,85,GEORGETOWN,73,158
1994,SYRACUSE,64,WISCONSIN-GB,59,123
1994,MISSOURI,109,WISCONSIN,96,205
1994,ARIZONA,71,VIRGINIA,58,129
1994,LOUISVILLE,60,MINNESOTA,55,115
1994,BOSTONCOLLEGE,77,INDIANA,68,145
1994,FLORIDA,69,CONNECTICUT,60,129
1994,DUKE,59,MARQUETTE,49,108
1994,PURDUE,83,KANSAS,78,161
1994,ARKANSAS,103,TULSA,84,187
1994,MICHIGAN,78,MARYLAND,71,149
1994,MISSOURI,98,SYRACUSE,88,186
1994,ARIZONA,82,LOUISVILLE,70,152
1994,FLORIDA,74,BOSTONCOLLEGE,66,140
1994,DUKE,69,PURDUE,60,129
1994,ARKANSAS,76,MICHIGAN,68,144
1994,ARIZONA,92,MISSOURI,72,164
1994,DUKE,70,FLORIDA,65,135
1994,ARKANSAS,91,ARIZONA,82,173
1994,ARKANSAS,76,DUKE,72,148
1995,WAKEFOREST,79,NORTHCAROLINAA&T,47,126
1995,ST.LOUIS,64,MINNESOTA,61,125
1995,ALABAMA,91,PENNSYLVANIA,85,176
1995,OKLAHOMASTATE,73,DREXEL,49,122
1995,STANFORD,70,NC-CHARLOTTE,68,138
1995,MASSACHUSETTS,68,ST.PETER'S,51,119
1995,OLDDOMINION,89,VILLANOVA,81,170
1995,TULSA,68,ILLINOIS,62,130
1995,MANHATTAN,77,OKLAHOMA,67,144
1995,ARIZONASTATE,81,BALLSTATE,66,147
1995,KENTUCKY,113,MOUNTST.MARY'S,67,180
1995,TULANE,76,BRIGHAMYOUNG,70,146
1995,IOWASTATE,64,FLORIDA,61,125
1995,NORTHCAROLINA,80,MURRAYSTATE,70,150
1995,WEBERSTATE,79,MICHIGANSTATE,72,151
1995,GEORGETOWN,68,XAVIER(OHIO),63,131
1995,MIAMI(OHIO),71,ARIZONA,62,133
1995,VIRGINIA,96,NICHOLLSSTATE,72,168
1995,KANSAS,82,COLGATE,68,150
1995,WESTERNKENTUCKY,82,MICHIGAN,76,158
1995,SYRACUSE,96,SOUTHERNILLINOIS,92,188
1995,ARKANSAS,79,TEXASSOUTHERN,78,157
1995,MEMPHIS,77,LOUISVILLE,56,133
1995,PURDUE,49,WISCONSIN-GB,48,97
1995,CONNECTICUT,100,TENNESSEE-CHAT,71,171
1995,CINCINNATI,77,TEMPLE,71,148
1995,TEXAS,90,OREGON,73,163
1995,MARYLAND,87,GONZAGA,63,150
1995,OKLAHOMASTATE,66,ALABAMA,52,118
1995,WAKEFOREST,64,ST.LOUIS,59,123
1995,MASSACHUSETTS,75,STANFORD,53,128
1995,TULSA,64,OLDDOMINION,52,116
1995,ARIZONASTATE,64,MANHATTAN,54,118
1995,KENTUCKY,82,TULANE,60,142
1995,GEORGETOWN,53,WEBERSTATE,51,104
1995,NORTHCAROLINA,73,IOWASTATE,51,124
1995,VIRGINIA,60,MIAMI(OHIO),54,114
1995,KANSAS,75,WESTERNKENTUCKY,70,145
1995,MEMPHIS,75,PURDUE,73,148
1995,ARKANSAS,96,SYRACUSE,94,190
1995,MISSISSIPPISTATE,78,UTAH,64,142
1995,UCLA,75,MISSOURI,74,149
1995,CONNECTICUT,96,CINCINNATI,91,187
1995,MARYLAND,82,TEXAS,68,150
1995,OKLAHOMASTATE,71,WAKEFOREST,66,137
1995,MASSACHUSETTS,76,TULSA,51,127
1995,NORTHCAROLINA,74,GEORGETOWN,64,138
1995,KENTUCKY,97,ARIZONASTATE,73,170
1995,VIRGINIA,67,KANSAS,58,125
1995,ARKANSAS,96,MEMPHIS,91,187
1995,UCLA,86,MISSISSIPPISTATE,67,153
1995,CONNECTICUT,99,MARYLAND,89,188
1995,OKLAHOMASTATE,68,MASSACHUSETTS,54,122
1995,NORTHCAROLINA,74,KENTUCKY,61,135
1995,ARKANSAS,68,VIRGINIA,61,129
1995,UCLA,102,CONNECTICUT,96,198
1995,UCLA,74,OKLAHOMASTATE,61,135
1995,ARKANSAS,75,NORTHCAROLINA,68,143
1995,UCLA,89,ARKANSAS,78,167
